FWWB	1ST WASHINGTON BANCORP INC
TW	20TH CENTURY INDS CAL
XO	360 COMMUNICATIONS CO
COMS	3COM CORP
NDN	99 CENTS ONLY STORES
AAM	AAMES FINANCIAL CORP
AIR	AAR CORPORATION
ARON	AARON RENTS INC
ABDR	ABACUS DIRECT CORP
ABT	ABBOTT LABORATORIES
ANF	ABERCROMBIE & FITCH CO
ABM	ABM INDUSTRIES INC
ABRX	ABR INFORMATION SERVICES INC
ABTC	ABT BUILDING PRODUCTS CORP
ACCC	ACC CORP
AIF	ACCEPTANCE INSURANCE COS INC
ACCS	ACCESS HEALTH MARKETING INC
AKLM	ACCLAIM ENTERTAINMENT INC
ASI	ACCUSTAFF INC
AK	ACKERLEY GROUP INC
AMI	ACME METALS INC
ART	ACNIELSON CORP
ACO	ACORDIA INC
ACTM	ACT MANUFACTURING INC
ACTL	ACTEL CORP
ACTN	ACTION PERFORMANCE COS INC
ATVI	ACTIVISION INC
ACN	ACUSON CORP
ACX	ACX TECHNOLOGIES INC
ACXM	ACXIOM CORP
ADAC	ADAC LABS
ADPT	ADAPTEC INC
ADCT	ADC TELECOMMUNICATIONS INC
ADEX	ADE CORP
ASF	ADMINISTAFF INC
ADBE	ADOBE SYSTEMS INC
ACCOB	ADOLPH COORS CO
ADTN	ADTRAN INC
AEIS	ADVANCED ENERGY INDUSTRIES INC
AFCI	ADVANCED FIBRE COMMUNICATION
ADLT	ADVANCED LIGHTING TECHS
AMD	ADVANCED MICRO DEVICES INC
ATLI	ADVANCED TECHNOLOGY LABS INC
ATMI	ADVANCED TECHNOLOGY MATERIAL
ATIS	ADVANCED TISSUE INC
ADVNA	ADVANTA CORP
ADVS	ADVENT SOFTWARE INC
AD	ADVO INC
AEPI	AEP INDUSTRIES INC
AERL	AERIAL COMMUNICATIONS INC
ANV	AEROQUIP-VICKERS INC
AES	AES CORP
AET	AETNA INC
AFCX	AFC CABLE SYSTEMS INC
AFA	AFFILIATED COMPUTER SVCS
AFFX	AFFYMETRIX INC
AFL	AFLAC INC
ATAC	AFTERMARKET TECHNOLOGY CORP
AGE	AG EDWARDS INC
AGCH	AG-CHEM EQUIPMENT CO INC
AG	AGCO CORP
ATG	AGL RESOURCES INC
AGPH	AGOURON PHARMACEUTICAL INC
AEIC	AIR EXPRESS INTL CORP
APD	AIR PRODUCTS & CHEMICALS INC
ABF	AIRBORNE FREIGHT CORP
ARG	AIRGAS INC
ANS	AIRNET SYSTEMS INC
ATI	AIRTOUCH COMMUNICATIONS INC
AKS	AK STEEL HOLDING CORP
ALG	ALAMO GROUP INC
ALK	ALASKA AIR GROUP
ALBK	ALBANK FINANCIAL CORP
AIN	ALBANY INTERNATIONAL CORP
ALB	ALBEMARLE CORP
ACV	ALBERTO CULVER CO
ABS	ALBERTSONS INC
AB	ALEX BROWN INC
ALEX	ALEXANDER & BALDWIN
ALX	ALEXANDER'S INC
ARE	ALEXANDRIA REAL ESTATE
ALFA	ALFA CORP
ALGO	ALGOS PHARMACEUTICALS CORP
ALNT	ALIANT COMMUNICATIONS INC
ALKS	ALKERMES INC
AACI	ALL AMERICAN COMMUNICATIONS
Y	ALLEGHANY CORP DEL
AYP	ALLEGHENY POWER SYSTEMS INC
ALT	ALLEGHENY TELEDYNE INC
AEH	ALLEGIANCE CORPORATION
ALN	ALLEN TELECOM INC
AGN	ALLERGAN INC
ALLP	ALLIANCE PHARMACEUTICAL CORP
ALSC	ALLIANCE SEMICONDUCTOR CORP
ATK	ALLIANT TECHSYSTEMS INC
ALCC	ALLIED CAPITAL COMMERCIAL
GRP	ALLIED GROUP INC
ADP	ALLIED PRODUCTS
AWIN	ALLIED WASTE INDUSTRIES INC
ALD	ALLIEDSIGNAL INC
AFC	ALLMERICA FINANCIAL CORP
APY	ALLMERICA PPTY & CAS COS INC
ALL	ALLSTATE CORP
AT	ALLTEL CORP
JARS	ALLTRISTA CORP
ALW	ALLWASTE INC
ALO	ALPHARMA INC
AGI	ALPINE GROUP INC
ALTR	ALTERA CORP
ALI	ALTERNATIVE LIVING SERVICES
ALRC	ALTERNATIVE RESOURCES CORP
ALRN	ALTRON INC
AMX	ALUMAX INC
AA	ALUMINUM CO OF AMERICA
AZA	ALZA CORP
AMTX	AMATI COMMUNICATIONS CORP
AU	AMAX GOLD INC
AMZN	AMAZON.COM INC
ABK	AMBAC INC
AAH	AMBASSADOR APTS INC
AEN	AMC ENTERTAINMENT INC
AIZ	AMCAST INDUSTRIAL CORP
ACOL	AMCOL INTERNATIONAL CORP
AMFI	AMCORE FINANCIAL INC
AMH	AMDAHL CORP
AHL	AMER HERITAGE LIFE
AHC	AMERADA HESS CORP
UHAL	AMERCO INC
AOL	AMERICA ONLINE INC DEL
AWA	AMERICA WEST HOLDINGS CORP
AAG	AMERICAN ANNUITY GROUP INC
ABIG	AMERICAN BANKERS INS GROUP INC
ABII	AMERICAN BUSINESS
ABP	AMERICAN BUSINESS PRODUCTS INC
AEP	AMERICAN ELECTRIC POWER CO INC
AX	AMERICAN EXPLORATION CO
AXP	AMERICAN EXPRESS CO
AMFB	AMERICAN FEDERAL BANK FSB
AFE	AMERICAN FINANCIAL ENTERPRISES
AFG	AMERICAN FINANCIAL GROUP INC
AFWY	AMERICAN FREIGHTWAYS CORP
AGT	AMERICAN GEN HOSPITALITY CORP
AGC	AMERICAN GENERAL CORP
AGREA	AMERICAN GREETINGS CORP
AHE	AMERICAN HEALTH PROPERTIES INC
AHP	AMERICAN HOME PRODUCTS CORP
AHOM	AMERICAN HOMEPATIENT INC
HSTR	AMERICAN HOMESTAR CORP
AIG	AMERICAN INTERNATIONAL GROUP
ENQ	AMERICAN MEDIA INC
AMSY	AMERICAN MGMT SYSTEMS INC
SKYC	AMERICAN MOBILE SATELLITE CORP
ANAT	AMERICAN NATIONAL INSURANCE
AORI	AMERICAN ONCOLOGY RESOURCES
AGP	AMERICAN PAD & PAPER CO
APCC	AMERICAN POWER CONVERSION CORP
AFM	AMERICAN RADIO SYSTEMS CORP
ARS	AMERICAN RESIDENTIAL SVCS
RAZR	AMERICAN SAFETY RAZOR CO
ASD	AMERICAN STANDARD COMPANIES
ASX	AMERICAN STATES FINANCIAL CORP
ASC	AMERICAN STORES CO
AWK	AMERICAN WATER WORKS CO INC
ACF	AMERICREDIT CORP
AMRN	AMERIN CORP
AAS	AMERISOURCE HEALTH CORP
AIT	AMERITECH CORP
AMTD	AMERITRADE HOLDING CORP
AMN	AMERON INTERNATIONAL CORP
AMRS	AMERUS LIFE HOLDINGS INC
AMES	AMES DEPT STORES INC
AME	AMETEK INC
AMGN	AMGEN INC
AML	AMLI RESIDENTIAL PROPERTIES
AN	AMOCO CORP
AMP	AMP INC
AXC	AMPEX CORP
APH	AMPHENOL CORP
AMR	AMR CORP
AMMB	AMRESCO INC
AMSN	AMSCAN HOLDINGS INC
ASO	AMSOUTH BANCORPORATION
AMV	AMVESTORS FINL CORP
AMLN	AMYLIN PHARMACEUTICALS INC
APC	ANADARKO PETROLEUM CORP
ANAD	ANADIGICS INC
ADI	ANALOG DEVICES INC
ALOG	ANALOGIC CORP
ANLY	ANALYSTS INTERNATIONAL CORP
ABCW	ANCHOR BANCORP WISCONSIN INC
SLOT	ANCHOR GAMING
ANDW	ANDREW CORP
ADRX	ANDX CORP
BUD	ANHEUSER BUSCH COS INC
AXE	ANIXTER INTL INC
ANN	ANNTAYLOR STORES CORP
ANTC	ANTEC CORP
AOC	AON CORPORATION
APAC	APAC TELESERVICES INC
APA	APACHE CORP
AIV	APARTMENT INVESTMENT & MGMT CO
APEX	APEX PC SOLUTIONS INC
APHT	APHTON CORPORATION
APL	APL LTD
APOG	APOGEE ENTERPRISES
APOL	APOLLO GROUP INC
AAPL	APPLE COMPUTER INC
APSO	APPLE SOUTH INC
APPB	APPLEBEE'S INTL INC
AAII	APPLIED ANALYTICAL INDS INC
AGTX	APPLIED GRAPHICS TECHNOLOGIES
APZ	APPLIED INDUSTRIAL
APM	APPLIED MAGNETICS
AMAT	APPLIED MATERIALS INC
APW	APPLIED POWER INC
AHG	APRIA HEALTHCARE GROUP INC
ATR	APTARGROUP INC
WTR	AQUARION COMPANY
AQP	AQUILA GAS PIPELINE CORP
ARBR	ARBOR DRUGS INC
AHCC	ARBOR HEALTH CARE COMPANY
ARSW	ARBOR SOFTWARE CORP
AAC	ARCADIA FINANCIAL LTD
ADM	ARCHER-DANIELS-MIDLAND CO
RCM	ARCO CHEMICAL CO
ACAT	ARCTIC CAT INC
ARI	ARDEN REALTY GROUP INC
AREA	AREA BANCSHARES CORP
AGII	ARGONAUT GROUP INC
ARGL	ARGYLE TELEVISION INC
AS	ARMCO INC
ACK	ARMSTRONG WORLD INDUSTRIES INC
AIND	ARNOLD INDUSTRIES INC
ARQL	ARQULE INC
ARRS	ARRIS PHARMACEUTICAL CORP
ARW	ARROW ELECTRONICS
ARRO	ARROW INTERNATIONAL INC
AVEI	ARTERIAL VASCULAR ENGINEERING
ARV	ARVIN INDS INC
ASAI	ASA HOLDINGS INC
AR	ASARCO INC
ASND	ASCEND COMMUNICATIONS INC
GOAL	ASCENT ENTERTAINMENT GROUP
ACI	ASHLAND COAL INC
ASH	ASHLAND INC
ASDV	ASPECT DEVELOPMENT INC
ASPT	ASPECT TELECOMMUNICATIONS CORP
AZPN	ASPEN TECHNOLOGY INC
ASBC	ASSOCIATED BANC-CORP
AEC	ASSOCIATED ESTATES REALITY CP
AGRPA	ASSOCIATED GROUP INC
AFS	ASSOCIATES FIRST CAPITAL CRP
ASTA	AST RESEARCH INC
ASFC	ASTORIA FINANCIAL CORP
ASYT	ASYST TECHNOLOGIES INC
ATX	A AT CROSS CO
T	AT&T CORP
ATE	ATLANTIC ENERGY CORP NJ
ARC	ATLANTIC RICHFIELD CO
ATLS	ATLAS AIR INC
ATML	ATMEL CORP
ATO	ATMOS ENERGY CORPORATION
ATRC	ATRIA COMMUNITIES INC
ATWD	ATWOOD OCEANICS
AURM	AURUM SOFTWARE INC
ASPX	AUSPEX SYSTEMS INC
ASM	AUTHENTIC FITNESS CORP
ADSK	AUTODESK INC
ALV	AUTOLIV INC
AUD	AUTOMATIC DATA PROCESSING INC
AZO	AUTOZONE INC
AVN	AVALON PROPERTIES INC
AVNT	AVANT! CORPORATION
AVTR	AVATAR HOLDINGS INC
AVY	AVERY DENNISON CORP
AVL	AVIALL INC
AVS	AVIATION SALES CO
AVID	AVID TECHNOLOGY INC
AVT	AVNET INC
AVP	AVON PRODUCTS CORP
AVDL	AVONDALE INDUSTRIES INC
AVX	AVX CORP
AWRE	AWARE INC/MASS
AZR	AZTAR CORP
GR	B F GOODRICH CO
BPI	BA MERCHANT SERVICES INC
BACU	BACOU USA INC
BHI	BAKER HUGHES INC
BEZ	BALDOR ELECTRIC CO
BWINB	BALDWIN & LYONS INC
BLL	BALL CORPORATION
BMP	BALLARD MEDICAL PRODUCTS
BGLV	BALLYS GRAND INC
BGE	BALTIMORE GAS & ELECTRIC CO
ONE	BANC ONE CORP
BANF	BANCFIRST CORP
BXS	BANCORPSOUTH INC
BTC	BANCTEC INC
BDG	BANDAG INC
GRAN	BANK OF GRANITE CORP NC
BK	BANK OF NEW YORK INC
BPLS	BANK PLUS CORPORATION
BNKU	BANK UNITED CORP
BAC	BANKAMERICA CORP
BANC	BANKATLANTIC BANCORP INC
BKB	BANKBOSTON CORPORATION
BKCO	BANKERS CORP
BT	BANKERS TRUST NY CORP
BKNG	BANKNORTH GROUP INC
BAR	BANNER AEROSPACE INC
BNTA	BANTA CORPORATION
BKS	BARNES & NOBLE INC
B	BARNES GROUP INC
BBI	BARNETT BANKS INC
BNTT	BARNETT INC
BRL	BARR LABORATORIES INC
BARZ	BARRA INC
BRR	BARRETT RESOURCES CORP
BSET	BASSETT FURNITURE INDUSTRIES
BMG	BATTLE MOUNTAIN GOLD CO
BOL	BAUSCH & LOMB INC
BAX	BAXTER INTERNATIONAL INC
BYA	BAY APARTMENT COMMUNITIES INC
BAY	BAY NETWORKS INC
BGC	BAY STATE GAS COMPANY
BVCC	BAY VIEW CAPITAL CORP DELAWARE
BBK	BB&T CORPORATION
BBN	BBN CORP
BDMI	BDM INTERNATIONAL INC
BEAV	BE AEROSPACE INC
BEAS	BEA SYSTEMS INC
BCN	BEACON PROPERTIES CORP
BSC	BEAR STEARNS COMPANIES INC
BEC	BECKMAN INSTRUMENTS INC
BDX	BECTON DICKINSON & CO
BBBY	BED BATH AND BEYOND INC
BED	BEDFORD PROPERTY INVESTORS
BOG	BELCO OIL & GAS CORP
BELD	BELDEN & BLAKE CORP
BWC	BELDEN INC
BHW	BELL & HOWELL CO
BEL	BELL ATLANTIC CORP
BLS	BELLSOUTH CORP
BLC	BELO A H CORP
BMS	BEMIS INC
BHE	BENCHMARK ELECTRONICS INC
BNL	BENEFICIAL CORP
BNO	BENTON OIL & GAS CO
BEI	BERG ELECTRONICS CORP
BBC	BERGEN BRUNSWIG
BKLY	BERKLEY W R CORP
BRI	BERKSHIRE REALTY COMPANY INC
BTZ	BERLITZ INTERNATIONAL INC
BRY	BERRY PETROLEUM COMPANY
BBY	BEST BUY INC
BTV	BET HOLDINGS INC
BS	BETHLEHEM STEEL CORP
BTL	BETZDEARBORN INC
BEV	BEVERLY ENTERPRISES INC
BGSS	BGS SYSTEMS INC
BHC	BHC COMMUNICATIONS INC
BGF	BIG FLOWER PRESS HLDGS INC
BILL	BILLING INFORMATION CONCEPTS
BDY	BINDLEY WESTERN INDUSTRIES INC
BIO	A BIO RAD LABS INC
BGEN	BIOGEN INC
BIOX	BIOMATRIX INC
BMET	BIOMET INC
BIOP	BIOPSYS MEDICAL INC
BTGC	BIO-TECHNOLOGY GENERAL CORP
BIR	BIRMINGHAM STEEL CORP
BSYS	BISYS GROUP INC
BJS	BJ SERVICES COMPANY
BDK	BLACK & DECKER CORP
BBOX	BLACK BOX CORPORATION
BKH	BLACK HILLS CORP
BLOCA	BLOCK DRUG INC
BLT	A BLOUNT INTL INC
BTH	BLYTH INDUSTRIES INC
BMC	BMC INDUSTRIES INC MINN
BMCS	BMC SOFTWARE INC
BOBE	BOB EVANS FARMS INC
BA	BOEING CO
BCC	BOISE CASCADE CORP
BOP	BOISE CASCADE OFFICE PRODUCT
BOKF	BOK FINANCIAL CORP
BOOL	BOOLE & BABBAGE INC
BGP	BORDERS GROUP INC
BOR	BORG WARNER SECURITIES CORP
BWA	BORG-WARNER AUTOMOTIVE INC
BORL	BORLAND INTERNATIONAL INC
SAM	BOSTON BEER COMPANY INC
BOST	BOSTON CHICKEN INC
BSE	BOSTON EDISON CO
BSX	BOSTON SCIENTIFIC CORP
BSN	BOSTON TECHNOLOGY INC
BOW	BOWATER INC
BNE	BOWNE & CO INC
BYD	BOYD GAMING CORP
BOY	BOYKIN LODGING COMPANY
BTR	BRADLEY REAL ESTATE INC
BRCOA	BRADY W H COMPANY
BRCP	BRC HOLDINGS INC
BRE	BRE PROPERTIES INC
BDT	BREED TECHNOLOGIES INC
BRBK	BRENTON BANKS INC
BGG	BRIGGS & STRATTON CORP
CELL	BRIGHTPOINT INC
EAT	BRINKER INTERNATIONAL INC
BH	BRISTOL HOTEL COMPANY
BMY	BRISTOL MYERS SQUIBB CO
BROD	BRODERBUND SOFTWARE INC
BU	BROOKLYN UNION GAS CO
BFPT	BROOKS FIBER PROPERTIES INC
BNS	BROWN & SHARPE MFG CO
TMBR	BROWN (TOM) INC
BF	B BROWN FORMAN CORP
BG	BROWN GROUP INC
BFI	BROWNING FERRIS INDUSTRIES INC
BC	BRUNSWICK CORP
BW	BRUSH WELLMAN INC
BYL	BRYLANE INC
BSBN	BSB BANCORP INC
BTFC	BT FINANCIAL CORP
BTF	BT OFFICE PRODUCTS INTL INC
BKI	BUCKEYE CELLULOSE CORP
BKE	BUCKLE INC
BD	BUDGET GROUP INC
BOCB	BUFFETS INC
BCF	BURLINGTON COAT FACTORY WHSE
BUR	BURLINGTON IND. INC
BNI	BURLINGTON NORTHERN SANTA FE
BR	BURLINGTON RESOURCES INC
BPP	BURNHAM PACIFIC PROPERTIES INC
BBRC	BURR-BROWN CORP
BOA	BUSH BOAKE ALLEN INC
BSH	BUSH INDUSTRIES INC
BBR	BUTLER MFG CO
BWF	BW/IP INC
CDI	C D I CORP
CFWC	C F W COMMUNICATIONS CO
BCR	C R BARD INC N.J.
CHP	C&D TECHNOLOGY INC
CDT	CABLE DESIGN TECHNOLOGIES
CS	CABLETRON SYSTEMS INC
CVC	CABLEVISION SYSTEMS CORP
CBT	CABOT CORP
COG	CABOT OIL & GAS CORP
CACI	CACI INTERNATIONAL INC
CDN	CADENCE DESIGN SYSTEMS INC
KDUS	CADUS PHARMACEUTICAL CORP
CEUS	CAIRN ENERGY USA INC
CE	CALENERGY INC
CCC	CALGON CARBON CORP
CLI	CALI REALTY CORP
CBB	CALIBER SYSTEM INC
CMIC	CALIFORNIA MICROWAVE INC
CWT	CALIFORNIA WATER SERVICE CO
ELY	CALLAWAY GOLF CO
CZM	CALMAT CO
CPN	CALPINE CORPORATION
CBM	CAMBREX CORP
CATP	CAMBRIDGE TECH PARTNERS INC
CAM	CAMCO INTERNATIONAL INC
CPT	CAMDEN PROPERTY TRUST
CPB	CAMPBELL SOUP CO LTD
WINEA	CANANDAIGUA WINE INC
CBCP	CAPITAL BANCORP MIAMI FL
CCBG	CAPITAL CITY BANK GROUP INC
CAPF	CAPITAL FACTORS HOLDINGS INC
COF	CAPITAL ONE FINANCIAL CORP
KRE	CAPITAL RE CORP
CATA	CAPITAL TRANSAMERICA CORP
KAP	CAPMAC HOLDINGS INC
CHO	CAPSTAR HOTEL COMPANY
CMO	CAPSTEAD MORTGAGE CORP
CCT	CAPSTONE CAPITAL TRUST INC
DOSE	CAPSTONE PHARMACY SERVICES
CSH	CAPSURE HOLDINGS CORP
CSAR	CARAUSTAR INDUSTRIES INC
CRBO	CARBO CERAMICS INC
CAH	CARDINAL HEALTH INC
CTSI	CARDIOTHORACIC SYSTEMS INC
CMD	CAREMATRIX CORPORATION
CWC	CARIBINER INTL INC
CSL	CARLISLE COMPANIES INC
CKE	CARMIKE CINEMAS INC
CPL	CAROLINA POWER & LIGHT CO
CRS	CARPENTER TECHNOLOGY CORP
CRE	CARRAMERICA REALTY CORP
CRP	CARSON PIRIE SCOTT & CO
CAR	CARTER WALLACE INC
CSCC	CASCADE COMMUNICATIONS CORP
CAE	CASCADE CORP
CSE	CASE CORP
CASY	CASEYS GENERAL STORES INC
PWN	CASH AMERICA INTL INC
CCS	CASTLE & COOKE INC
CAS	CASTLE A M & CO
POS	CATALINA MARKETING CORP
CDX	CATELLUS DEVELOPEMENT CORP
CAT	CATERPILLAR INC
CBCG	CB COMMERCIAL REAL ESTATE
CBL	CBL & ASSOCIATES PROPERTIES
CBTC	CBT CORP - KY
CCB	CCB FINANCIAL CORP
CCCG	CCC INFORMATION SERVICES GRP
CUBE	C-CUBE MICROSYSTEMS INC
CDWC	CDW COMPUTER CENTERS INC
CNDS	CELLNET DATA SYSTEMS INC
CLST	CELLSTAR CORPORATION
CCIL	CELLULAR COMMUNICATIONS INTL
CTSC	CELLULAR TECHNICAL SVCS INC
CYCL	CENTENNIAL CELLULAR CORP
CX	CENTERIOR ENERGY CORP
CNT	CENTERPOINT PROPERTIES CORP
CXP	CENTEX CONSTRUCTION PRODUCTS
CTX	CENTEX CORP
CNTO	CENTOCOR INC
CSR	CENTRAL & SOUTH WEST CORP
CFBS	CENTRAL FIDELITY BANKS INC
CENT	CENTRAL GARDEN & PET CO
CNH	CENTRAL HUDSON GAS & ELECTRIC
CNL	CENTRAL LOUISIANA ELECTRIC CO
CTP	CENTRAL MAINE POWER
ECP	CENTRAL NEWSPAPERS INC
PK	CENTRAL PARKING CORP
CBC	CENTURA BANKS INC
CENX	CENTURY ALUMINUM COMPANY
CTYA	CENTURY COMMUNICATIONS CORP
CTL	CENTURY TELEPHONE ENTERPRISES
CEPH	CEPHALON INC
CEN	CERIDIAN CORP
CERN	CERNER CORP
CFMT	CFM TECHNOLOGIES INC
CFX	CFX CORPORATION
CHB	CHAMPION ENTERPRISES INC
CHA	CHAMPION INTERNATIONAL CORP
CBCA	CHANCELLOR BROADCASTING
CSM	CHAPARRAL STEEL CO
CHRS	CHARMING SHOPPES INC
CTI	CHART INDUSTRIES INC
COFI	CHARTER ONE FINANCIAL INC
CWL	CHARTWELL RE CORPORATION
CSI	CHASE INDUSTRIES INC
CMB	CHASE MANHATTAN CORP
CPJ	CHATEAU COMMUNITIES INC
CKFR	CHECKFREE CORP
CKP	CHECKPOINT SYSTEM INC
CAKE	CHEESECAKE FACTORY INC
CCG	CHELSEA GCA REALTY INC
CHE	CHEMED CORP
CEM	CHEMFIRST INC
CHFC	CHEMICAL FINANCIAL CORP
CSK	CHESAPEAKE CORP
CHK	CHESAPEAKE ENERGY CORP
CHV	CHEVRON CORP
CHML	CHICAGO MINIATURE LAMP INC
CHPS	CHIPS & TECHNOLOGIES INC
CQB	CHIQUITA BRANDS INTL INC
CHIR	CHIRON CORP
CNDN	CHITTENDEN CORP
CHH	CHOICE HOTELS CORP INC
CCN	CHRIS CRAFT INDUSTRIES INC
CST	CHRISTIANA COMPANIES INC
C	CHRYSLER CORP
CHSE	CHS ELECTRONICS INC
CB	CHUBB CORP
CHD	CHURCH & DWIGHT INC
CBR	CIBER INC
CDCO	CIDCO INC
CIEN	CIENA CORP
CI	CIGNA CORP
CER	CILCORP INC
CSN	CINCINNATI BELL INC
CINF	CINCINNATI FINANCIAL CORP
CMZ	CINCINNATI MILACRON INC
CIN	CINERGY CORP
CTAS	CINTAS CORP
CIP	CIPSCO INC
CRCL	CIRCLE INTERNATIONAL GRP INC
KMX	CIRCUIT CITY STORES CARMAX
CC	CIRCUIT CITY STORES-CIRCUIT
CIR	CIRCUS CIRCUS ENTERPRISES INC
CRUS	CIRRUS LOGIC INC
CSCO	CISCO SYSTEMS INC
CAST	CITATION CORP
CCI	CITICORP
CTZN	CITIFED BANCORP INC
CICS	CITIZENS BANCSHARES INC
CBCF	CITIZENS BANKING CORP
CZC	CITIZENS CORP
CZN	A CITIZENS UTILITIES
CTXS	CITRIX SYSTEMS INC
CYN	CITY NATIONAL CORP
CTYS	CITYSCAPE FINANCIAL CORP
CKR	CKE RESTAURANTS INC
CKSG	CKS GROUP INC
CLE	CLAIRE'S STORES INC
CLC	CLARCOR INC
CLMT	CLAREMONT TECHNOLOGY GROUP
CLFY	CLARIFY INC
CMH	CLAYTON HOMES INC
CCU	CLEAR CHANNEL COMMUNICATIONS
CLF	CLEVELAND-CLIFFS INC
CDG	CLIFFS DRILLING CO
CCRO	CLINTRIALS RESEARCH INC
CLX	CLOROX CO
CLSR	CLOSURE MEDICAL CORPORATION
CMT	CMAC INVESTMENT CORP
CMS	CMS ENERGY CORP
CNA	CNA FINANCIAL CORP
BNK	CNB BANCSHARES INC
CNWK	CNET INC
CNF	CNF TRANSPORTATION INC
CNXS	CNS INC
CUI	COACH USA INC
COA	COACHMEN INDUSTRIES INC
CSA	COAST SAVINGS FINANCIAL INC
CGP	COASTAL CORP
COKE	COCA COLA BOTTLING CO CONS
KO	COCA COLA CO
CCE	COCA-COLA ENTERPRISES INC
CDE	COEUR D'ALENE MINES CORP IDAHO
CGNX	COGNEX CORP
CZT	COGNIZANT CORP
CCSC	COHERENT COMMUNICATIONS SYS
COHR	COHERENT INC
COHO	COHO ENERGY INC
COHU	COHU INC
WDRY	COINMACH LAUNDRY CORP
CNJ	COLE NATIONAL CORP
CLN	COLEMAN INC
CL	COLGATE PALMOLIVE CO
COFD	COLLECTIVE BANCORP INC
CKC	COLLINS & AIKMAN CORP
CNB	COLONIAL BANCGROUP INC
CGES	COLONIAL GAS CO
CLP	COLONIAL PROPERTIES TRUST
COT	COLTEC INDUSTRIES INC
CG	COLUMBIA GAS SYSTEM INC
COL	COLUMBIA HCA HEALTHCARE CORP
COB	COLUMBIA LABORATORIES INC
CMCO	COLUMBUS MCKINNON CORP
CLB	COLUMBUS REALTY TRUST
COMR	COMAIR INC
CMCSK	COMCAST CORP
CDO	COMDISCO INC
CMA	COMERICA INC
CBH	COMMERCE BANCORP INC NJ
CBSH	COMMERCE BANCSHARES INC
CGI	COMMERCE GROUP INC
CFB	COMMERCIAL FEDERAL CORP
TEC	COMMERCIAL INTERTECH CORP
CMC	COMMERCIAL METALS CO
NNN	COMMERICAL NET LEASE REALTY
CELS	COMMNET CELLULAR INC
CMSB	COMMONWEALTH BANCORP INC
CES	COMMONWEALTH ENERGY SYSTEMS
CMIN	COMMONWEALTH INDUSTRIES INC
CBSI	COMMUNITY BANK SYSTEM INC
CFBX	COMMUNITY FIRST BANKSHARES INC
CTBI	COMMUNITY TRUST BANCORP INC
CPQ	COMPAQ COMPUTER
CBSS	COMPASS BANCSHARES INC
CPDN	COMPDENT CORPORATION
CBSL	COMPLETE BUSINESS SOLUTIONS
CMPC	COMPUCOM SYSTEMS INC
CPU	COMPUSA INC
CSRV	COMPUSERVE CORP
CA	COMPUTER ASSOCIATES INTL INC
CHRZ	COMPUTER HORIZONS CORP
CLCX	COMPUTER LEARNING CENTERS INC
CMSX	COMPUTER MANAGEMENT SCIENCES
CPRD	COMPUTER PRODUCTS INC
CSC	COMPUTER SCIENCES CORP
TSK	COMPUTER TASK GROUP INC
CVN	COMPUTERVISION CORP
CPWR	COMPUWARE CORP
CQ	COMSAT CORP
CRK	COMSTOCK RESOURCES INC
CMVT	COMVERSE TECHNOLOGY INC
CAG	CONAGRA INC
CEFT	CONCORD EFS INC
COE	CONE MILLS CORP N C
CNMD	CONMED CORP
CNE	CONNECTICUT ENERGY CORP
CIG	CONS CIGAR HOLDINGS INC
CNC	CONSECO INC
ED	CONSOLIDATED EDISON CO NY INC
CFWY	CONSOLIDATED FREIGHTWAYS CORP
CGX	CONSOLIDATED GRAPHICS INC
CNG	CONSOLIDATED NATURAL GAS CO
CDP	CONSOLIDATED PAPERS INC
COP	CONSOLIDATED PRODUCTS INC
CNS	CONSOLIDATED STORES CORP
CFN	CONTIFINANCIAL CORP
CAI	B CONTINENTAL AIRLINES CORP
CDAT	CONTROL DATA SYSTEMS INC
CVE	CONVERSE INC
RON	COOPER CAMERON CORP
COO	COOPER COMPANIES INC
CBE	COOPER INDUSTRIES INC
CTB	COOPER TIRE & RUBBER
CPRT	COPART INC
COPY	COPYTELE INC
CORR	COR THERAPEUTICS INC
CRI	CORE INDUSTRIES
COMM	CORECOMM INC
CSTF	CORESTAFF INC
CFL	CORESTATES FINANCIAL CORP
CPP	CORNERSTONE PROPERTIES INC
TCR	CORNERSTONE REALTY INCOME TR
GLW	CORNING INC
CEXP	CORPORATE EXPRESS INC
CXC	CORRECTIONS CORP OF AMERICA
CBS	CORT BUSINESS SERVICES CORP
CORS	CORUS BANKSHARES INC
CPWM	COST PLUS INC
COST	COSTCO COMPANIES INC
CCR	COUNTRYWIDE CREDIT INDUSTRIES
CUZ	COUSINS PROPERTIES INC
CVD	COVANCE INC
CVTI	COVENANT TRANSPORT INC
CVTY	COVENTRY CORP
COX	COX COMMUNICATIONS INC
CXR	COX RADIO INC
CPBI	CPB INC
CPC	CPC INTERNATIONAL INC
CPY	CPI CORP
CRAA	CRA MANAGED CARE INC
CBRL	CRACKER BARREL OLD COUNTRY
CR	CRANE CO
CRD	B CRAWFORD & CO
CBMI	CREATIVE BIOMOLECULES INC
CMOS	CREDENCE SYSTEMS CORP
CACC	CREDIT ACCEPTANCE CORP
CEI	CRESCENT REAL ESTATE EQT CO
CF	CRESTAR FINANCIAL CORP
CMM	CRIMI MAE INC
CNK	CROMPTON & KNOWLES
XTO	CROSS TIMBERS OIL COMPANY
XC	CROSS-CONTINENT AUTO RETAILERS
CWN	CROWN AMERICAN REALTY
CCK	CROWN CORK & SEAL CO INC
CSGS	CSG SYSTEMS INTL INC
CSS	CSS INDUSTRIES INC
CSX	CSX CORP
CTEX	C-TEC CORP
CTG	CTG RES INC
CTS	CTS CORP
CUB	CUBIC CORP
CU	CUC INTERNATIONAL INC
CBO	CULBRO CORP
CFBI	CULLEN/FROST BANKERS INC
CUL	CULLIGAN WTR TECHNOLOGIES INC
CFI	CULP INC
CUM	CUMMINS ENGINE CO INC
CUNO	CUNO INCORPORATED
CURE	CURATIVE TECHNOLOGIES INC
CW	CURTISS-WRIGHT
CVB	CVB FINANCIAL CORP
CVS	CVS CORP
CWM	CWM MTG HLDGS INC
CYBR	CYBERMEDIA INC
CYGN	CYGNUS INC
CYLK	CYLINK CORP
CYMI	CYMER INC
CY	CYPRESS SEMICONDUCTOR CORP
CYM	CYPRUS AMAX MINERALS CO
CYRX	CYRIX CORP
CYT	CYTEC INDUSTRIES INC
CYTO	CYTOGEN CORP
CYTC	CYTYC CORPORATION
DRL	D I INDS INC
DHI	D R HORTON INC
DZTK	DAISYTEK INTL CORP
DS	DALLAS SEMICONDUCTOR CORP
DTL	DAL-TILE INTERNATIONAL INC
DM	DAMES & MOORE INC
DCN	DANA CORP
DHR	DANAHER CORP
DAN	DANIEL INDS
DRI	DARDEN RESTAURANTS INC
DARTA	DART GROUP CORP
DDIM	DATA DIMENSIONS INC
DGN	DATA GENERAL CORP
DPRC	DATA PROCESSING RESOURCES CORP
DTLN	DATA TRANSMISSION NETWORK CORP
DSCP	DATASCOPE INC
DAPN	DAUPHIN DEPOSIT CORP
DAVX	DAVOX CORP
DAYR	DAY RUNNER INC
DH	DAYTON HUDSON CORP
DBTO	DBT ONLINE INC
DF	DEAN FOODS CO
DOCI	DECISIONONE CORP
DE	DEERE & CO
DKB	DEKALB GENETICS CORP
DLI	DEL LABORATORIES INC
DLCH	DELCHAMPS INC
DLIA	DELIA*S INC
DELL	DELL COMPUTER CORP
DEW	DELMARVA POWER & LIGHT CO
DFG	DELPHI FINANCIAL GROUP INC
DLP	DELTA & PINE LAND CO
DAL	DELTA AIRLINES INC
DFC	DELTA FINANCIAL CORP
DLTK	DELTEK SYSTEMS INC
DEL	DELTIC TIMBER CORP
DLX	DELUXE CORP
XRAY	DENTSPLY INTL INC
DFS	DEPARTMENT 56 INC
DEP	DEPOSIT GUARANTY CORP
DPU	DEPUY INC
DSH	DESIGNER HOLDINGS LTD
ENG	DESTEC ENERGY INC
DDC	DETROIT DIESEL CORP
DDR	DEVELOPERS DIVERSIFIED REALTY
DVN	DEVON ENERGY CORP
DEVN	DEVON GROUP INC
DV	DEVRY INC DEL
DEX	DEXTER CORP
DP	DIAGNOSTIC PRODUCTS CORP
DL	DIAL CORP
DLGC	DIALOGIC CORP
DIMD	DIAMOND MULTIMEDIA SYSTEMS INC
DO	DIAMOND OFFSHORE DRILLING
DBD	DIEBOLD INC
DEC	DIGITAL EQUIPMENT CORP
DIGL	DIGITAL LIGHTWAVE INC
DLNK	DIGITAL LINK CORP
DMIC	DIGITAL MICROWAVE CORP
DIIG	DII GROUP INC
DDS	DILLARDS INC
DME	DIME BANCORP INC
DIME	DIME COMMUNITY BANCORP INC
DMN	DIMON INC
DNEX	DIONEX CORP
DAP	DISCOUNT AUTO PARTS INC
DLBI	DLB OIL & GAS INC
DCTM	DOCUMENTUM INC
DOL	DOLE FOOD COMPANY INC
DG	DOLLAR GENERAL CORP
DLTR	DOLLAR TREE STORES INC
DFF	DOMINICK'S SUPERMARKETS INC
D	DOMINION RESOURCES INC VA
DCI	DONALDSON INC
DLJ	DONALDSON LUFKIN & JENRETTE
DK	DONNA KARAN INTL INC
TREE	DOUBLETREE CORP
DOV	DOVER CORP
DVD	DOVER DOWNS ENTERTAINMENT CO
DOW	DOW CHEMICAL CO
DJ	DOW JONES & CO INC
DSL	DOWNEY FINANICAL
DPL	DPL INC
DQE	DQE INC
DBRN	DRESS BARN INC
DI	DRESSER INDUSTRIES INC
DRYR	DREYERS GRAND ICE CREAM INC
DIGI	DSC COMMUNICATIONS CORP
DSPC	DSP COMMUNICATIONS INC
DST	DST SYSTEMS INC
DTII	DT INDUSTRIES INC
DTE	DTE ENERGY COMPANY
DD	DU PONT E I DE NEMOURS & CO
DCO	DUCOMMUN INC DEL
DUK	DUKE ENERGY CORP
DRE	DUKE REALTY INVESTMENTS INC
DNB	DUN & BRADSTREET CORP
DPMI	DUPONT PHOTOMASKS INC
DURA	DURA PHARMACEUTICALS INC
DURI	DURCO INTERNATIONAL INC
DFI	DUTY FREE INTERNATIONAL INC
DYA	DYNAMICS CORP OF AMERICA
DYT	DYNATECH CORP
DX	DYNEX CAPITAL INC
EGRP	E*TRADE GROUP INC
EWB	E.W. BLANCH HOLDINGS INC
EAGL	EAGLE HARDWARE & GARDEN INC
EUSA	EAGLE USA AIRFREIGHT INC
EGR	EARTHGRAINS CO
EFU	EASTERN ENTERPRISES
EUA	EASTERN UTILITIES ASSOCIATES
EGP	EASTGROUP PROPERTIES
EMN	EASTMAN CHEMICAL CO
EK	EASTMAN KODAK CO
ETN	EATON CORP
EV	EATON VANCE CORP COM NON VTG
ECH	ECHLIN INC
DISH	ECHOSTAR COMMUNICATIONS
ECL	ECOLAB INC
EDFY	EDIFY CORP
EIX	EDISON INTERNATIONAL
EDMC	EDUCATION MANAGEMENT CORP
EGG	EG&G INC
ENBX	EINSTEIN/NOAH BAGEL CORP
EE	EL PASO ELECTRIC COMPANY
EPG	EL PASO NATURAL GAS
ELK	ELCOR CORP
ELRC	ELECTRO RENT CORP
ESIO	ELECTRO SCIENTIFIC INDS INC
EGLS	ELECTROGLAS INC
ERTS	ELECTRONIC ARTS
EDS	ELECTRONIC DATA SYSTEMS CORP
EFII	ELECTRONICS FOR IMAGING
LLY	ELI LILLY & CO
ELTN	ELTRON INTERNATIONAL INC
EMC	EMC CORPORATION (MASS)
EMCR	EMCARE HOLDINGS INC
EMR	EMERSON ELECTRIC CO
EMIS	EMISPHERE TECHNOLOGIES INC
EMMS	EMMIS BROADCASTING CORP
EDE	EMPIRE DISTRICT ELECTRIC CO
ESOL	EMPLOYEE SOLUTIONS INC
ENCD	ENCAD INC
WIRE	ENCORE WIRE CORP
EGN	ENERGEN CORP
EC	ENGELHARD CORP
EFS	ENHANCE FINL SVCS GROUP INC
ENA	ENOVA CORPORATION
ENE	ENRON CORP
EOG	ENRON OIL & GAS CO
ESV	ENSCO INTERNATIONAL INC
ENS	ENSERCH CORP
EEX	ENSERCH EXPLORATION INC
ETR	ENTERGY CORP
ENVY	ENVOY CORPORATION
ENZ	ENZO BIOCHEM INC
EFX	EQUIFAX INC
EQ	EQUITABLE COMPANIES INC
EIC	EQUITABLE IOWA COS COM
EQT	EQUITABLE RESOURCES INC
EQU	EQUITY CORP INTL
ENN	EQUITY INNS INC
EQR	EQUITY RESIDENTIAL PROPS TR
ERIE	ERIE INDEMNITY CO
ESST	ESS TECHNOLOGY
SXC	ESSEX INTERNATIONAL INC
ESS	ESSEX PROPERTY TRUST INC
EL	ESTEE LAUDER COMPANIES
ESL	ESTERLINE TECHNOLOGIES CORP
ETEC	ETEC SYSTEMS INC
ETH	ETHAN ALLEN INTERIORS INC
EY	ETHYL CORP
ETW	E'TOWN CORP
ESCC	EVANS & SUTHERLAND COMPUTER
EWR	EVANS WITHYCOMBE RESIDENTIAL
EVR	EVEREN CAPITAL CORP
RE	EVEREST REINSURANCE HLDGS
EVGM	EVERGREEN MEDIA CORP
EVI	EVI INC
EXBT	EXABYTE CORP
EXAR	EXAR CORP
ECI	EXCEL COMMUNICATIONS INC
EXC	EXCEL INDUSTRIES INC
XEL	EXCEL REALTY TRUST INC
ER	EXECUTIVE RISK INC
EX	EXIDE CORP
EXPD	EXPEDITORS INTERNATIONAL OF
ESRX	EXPRESS SCRIPTS INC
ESA	EXTENDED STAY AMERICA INC
XON	EXXON CORP
FMBK	F & M BANCORPORATION INC/WI
FMN	F & M NATIONAL CORP
FBAN	F N B CORP
FIT	FAB INDUSTRIES INC
FCA	A FABRI-CENTERS OF AMERICA
FDS	FACTSET RESEARCH SYSTEMS INC
FIC	FAIR ISSAC & CO INC
FA	FAIRCHILD CORP
FFD	FAIRFIELD COMMUNITIES INC
FLC	FALCON DRILLING COMPANY INC
FDO	FAMILY DOLLAR STORES INC
FGCI	FAMILY GOLF CENTERS INC
FARM	FARMER BROTHERS CO
FAST	FASTENAL CO
FFG	FBL FINANCIAL GROUP INC
FJC	FEDDERS USA INC
FDX	FEDERAL EXPRESS CORP
FMO	FEDERAL MOGUL CORP
FNM	FEDERAL NATIONAL MORTGAGE ASSN
FRT	FEDERAL REALTY INVESTMENT TR
FSS	FEDERAL SIGNAL CORP
FD	FEDERATED DEPT STORES INC
FEIC	FEI COMPANY
FCH	FELCOR SUITE HOTELS INC
FOE	FERRO CORP
FNF	FIDELITY NATIONAL FINANCIAL
FITB	FIFTH THIRD BANCORP
FIGIA	FIGGIE INTERNATIONAL INC
FILE	FILENET CORP
FI	FINA INC
FIF	FINANCIAL FEDERAL CORP
FINE	FINE HOST CORP
FHT	FINGERHUT COMPANIES INC
FINL	FINISH LINE INC
FSA	FINL SECURITY ASSURANCE HLDG
FNV	FINOVA GROUP INC
FATS	FIREARMS TRAINING SYSTEMS INC
FATN	FIRST AMERICAN CORP
FAF	FIRST AMERICAN FINANCIAL CORP
FBS	FIRST BANK SYSTEMS INC
FBR	FIRST BRANDS CORP
FCN	FIRST CHICAGO NBD CORP
FCNCA	FIRST CITIZENS BANCSHARES INC
FFBA	FIRST COLORADO BANCORP INC
FCBIB	FIRST COMMERCE BANCSHARES INC
FCOM	FIRST COMMERCE CORP
FCLR	FIRST COMMERCIAL CORP
FCF	FIRST COMMONWEALTH FINL CORP
FDC	FIRST DATA CORP
FES	FIRST EMPIRE STATE CORP
FTFC	FIRST FEDERAL CAPITAL CORP
FFBC	FIRST FINANCIAL BANCORP
FFIN	FIRST FINANCIAL BANKSHARES INC
FRCC	FIRST FINANCIAL CARIBBEAN CORP
FFHC	FIRST FINANCIAL CORP
THFF	FIRST FINANCIAL CORP/INDIANA
FFCH	FIRST FINANCIAL HOLDINGS INC
FHWN	FIRST HAWAIIAN INC
FISB	FIRST INDIANA CORP
FR	FIRST INDUSTRIAL REALTY TR INC
FMBC	FIRST MICHIGAN BANK CORP
FMBI	FIRST MIDWEST BANCORP INC
FOA	FIRST OF AMERICA BANK CORP
FRC	FIRST REPUBLIC BANCORPORATION
FSLA	FIRST SAVINGS BANK
FSCO	FIRST SECURITY CORP
SRCE	FIRST SOURCE CORP
FTEN	FIRST TENNESSEE NATIONAL CORP
FTU	FIRST UNION CORP
FUR	FIRST UNION REAL ESTATE EQUITY
UNTD	FIRST UNITED BANCSHARES INC
PTI	FIRST USA PAYMENTECH INC
FVB	FIRST VIRGINIA BANKS INC
FWBI	FIRST WESTERN BANCORP
FSR	FIRSTAR CORP
FBIC	FIRSTBANK OF ILLINOIS CO
FBP	FIRSTBANK PUERTO RICO
FED	FIRSTFED FINANCIAL CORP
FFSW	FIRSTFEDERAL FINL SVCS CORP
FMER	FIRSTMERIT CORPORATION
FPFG	FIRSTPLUS FINANCIAL GROUP
FISV	FISERV INC
FSH	FISHER SCIENTIFIC INTL INC
FLGS	FLAGSTAR BANCORP INC
FLT	FLEET FINANCIAL GROUP INC
FLE	FLEETWOOD ENTERPRISES INC
FLM	FLEMING COS INC
FLA	FLORIDA EAST COAST INDUSTRIES
PUCK	FLORIDA PANTHERS HOLDINGS
FPC	FLORIDA PROGRESS CORP
FRK	FLORIDA ROCK INDUSTRIES INC
FLO	FLOWERS INDUSTRIES INC
FLK	FLUKE CORP
FLR	FLUOR CORP
FMC	FMC CORP
FMXI	FOAMEX INTERNATIONAL INC
FONX	FONIX CORP
FDLNB	FOOD LION INC
FM	FOODMAKER INC
FTS	FOOTSTAR INC
FEN	FORCENERGY GAS EXPLORATION INC
F	FORD MOTOR CO
FORE	FORE SYSTEMS INC
FOM	FOREMOST CORP OF AMERICA
FCE	A FOREST CITY ENTERPRISES INC
FRX	FOREST LABS INC
FOIL	FOREST OIL CORP
FORR	FORRESTER RESEARCH INC
FORT	FORT HOWARD CORP
FWNC	FORT WAYNE NATIONAL CORP
FRTE	FORTE SOFTWARE INC
FO	FORTUNE BRANDS INC
FOSL	FOSSIL INC
FWC	FOSTER WHEELER CORP
FHS	FOUNDATION HEALTH SYSTEMS
FPAM	FPA MEDICAL MANAGEMENT INC
FPL	FPL GROUP INC
FFA	FRANCHISE FINANCE CORP OF AMER
FC	FRANKLIN COVEY CO
FELE	FRANKLIN ELECTRIC CO INC
BEN	FRANKLIN RESOURCES INC
FMY	FRED MEYER INC
FRE	FREDDIE MAC
FCX	FREEPORT MCMORAN COPPER & GOLD
FTX	FREEPORT MCMORAN INC
FMT	FREMONT GENERAL CORP
FRDM	FRIEDMAN'S INC
FRTZ	FRITZ COMPANIES INC
FRO	FRONTIER CORP
FTR	FRONTIER INSURANCE GROUP INC
FTL	FRUIT OF THE LOOM INC
FSII	FSI INTERNATIONAL INC
FTPS	FTP SOFTWARE INC
FUSE	FUISZ TECHNOLOGIES LTD
FULT	FULTON FINANCIAL CORP
FFC	FUND AMERICAN ENTERPRISES
FBN	FURNITURE BRANDS INTL INC
FCY	FURON CO
FUSN	FUSION SYSTEMS CORP
GKSRA	G & K SERVICES INC
GBP	GABLES RESIDENTIAL TRUST
GADZ	GADZOOKS INC
GNA	GAINSCO INC
GNL	GALEY & LORD INC
AJG	GALLAGHER (ARTHUR J.) & CO
GAL	GALOOB TOYS INC
GC	GANCARE INC
GCI	GANNETT CO INC
GPS	GAP INC
GRDG	GARDEN RIDGE CORP
GDMI	GARDNER DENVER MACHINERY INC
GART	GARTNER GROUP INC
GTW	GATEWAY 2000 INC
GMT	GATX CORP
GCR	GAYLORD CONTAINER CORP
GET	GAYLORD ENTERTAINMENT CO
GBCB	GBC BANCORP CALIF
GCX	GC COMPANIES INC
GELX	GELTEX PHARMACEUTICALS INC
GY	GENCORP INC
GBND	GENERAL BINDING CORP
GCN	GENERAL CABLE CORP
GCG	GENERAL CHEMICAL GROUP INC
MPP	GENERAL CIGAR HOLDINGS INC
GNCMA	GENERAL COMMUNICATION INC
GDC	GENERAL DATACOMM INDUSTRIES
GD	GENERAL DYNAMICS CORP
GE	GENERAL ELECTRIC CO
GGP	GENERAL GROWTH PROPERTIES INC
GIC	GENERAL INSTRUMENT CORP
GIS	GENERAL MILLS INC
GM	GENERAL MOTORS CORP
GMH	GENERAL MOTORS CORP
GNCI	GENERAL NUTRITION COMPANIES
GRN	GENERAL RE CORP
GSX	GENERAL SIGNAL CORP
GCO	GENESCO INC
GHV	GENESIS HEALTH VENTURES INC
GDX	A GENOVESE DRUG STORES INC
GEN	GENRAD INC
GNSA	GENSIA SICOR INC
GNTX	GENTEX CORP
GPC	GENUINE PARTS CO
GENZ	GENZYME CORP-GENL DIVISION
GON	GEON CO
GGC	GEORGIA GULF CORP
GP	GEORGIA PACIFIC CORP
GOTK	GEOTEK COMMUNICATIONS I
GEOC	GEOTEL COMMUNICATIONS CORP
GRB	GERBER SCIENTIFIC INC
GGO	GETCHELL GOLD CORPORATION
GTY	GETTY REALTY CORP
GCHI	GIANT CEMENT HOLDING INC
GFS	A GIANT FOOD INC
ROCK	GIBRALTAR STEEL CORP
GIBG	GIBSON GREETINGS INC
GIDL	GIDDINGS & LEWIS INC WIS
GILD	GILEAD SCIENCES INC
G	GILLETTE CO
GLT	GLATFELTER P H CO
GLE	GLEASON CORP
GEMS	GLENAYRE TECHNOLOGIES INC
GLB	GLENBOROUGH REALTY TRUST INC
GLN	GLENDALE FEDERAL BANK
GRT	GLIMCHER REALTY TRUST
GML	GLOBAL DIRECTMAIL CORP
GLBL	GLOBAL INDUSTRIES LTD
GIX	GLOBAL INDUSTRIES TECH INC
GLM	GLOBAL MARINE INC
GBFE	GOLDEN BOOKS FAMILY ENTMNT
CHIK	GOLDEN POULTRY CO INC
GDW	GOLDEN WEST FINANCIAL CORP DEL
GT	GOODYEAR TIRE & RUBBER CO
GDYS	GOODYS FAMILY CLOTHING INC
GPU	GPU INC
GGG	GRACO INC
GFI	GRAHAM-FIELD HEALTH PRODUCTS
GND	GRAND CASINOS INC
GPFI	GRAND PREMIER FINL INC
GVA	GRANITE CONSTRUCTION INC
GAP	GREAT ATLANTIC & PACIFIC
GTFN	GREAT FINANCIAL CORP
GLK	GREAT LAKES CHEMICAL CORP
GL	GREAT LAKES REIT INC
GWF	GREAT WESTERN FINANCIAL CORP
GRTR	GREATER NEW YORK SAVINGS BANK
GFII	GREENFIELD INDUSTRIES INC
GPT	GREENPOINT FINANCIAL CORP
GNT	GREENTREE FINANCIAL CORP
GASIA	GREENWICH AIR SERVICES INC
GBCOA	GREIF BROS CORP
GREY	GREY ADVERTISING INC
BUS	GREYHOUND LINES INC
GFF	GRIFFON CORPORATION
GBE	GRUBB & ELLIS CO
GTIS	GT INTERACTIVE SOFTWARE CORP
GTE	GTE CORP
GTK	GTECH HOLDINGS CORP
GUAR	GUARANTEE LIFE COMPANIES INC
GNC	GUARANTY NATIONAL CORP
GES	GUESS ? INC
GDT	GUIDANT CORP
GFD	GUILFORD MILLS INC
GLFD	GUILFORD PHARMACEUTICALS INC
GTRC	GUITAR CENTER INC
GSMS	GULF SOUTH MEDICAL SUPPLY
GAC	GULFSTREAM AEROSPACE CORP
GYMB	GYMBOREE CORP
HRB	H & R BLOCK INC
FULL	H B FULLER
AHM	H F AHMANSON & CO
HNZ	H J HEINZ CO
HACH	HACH COMPANY
HDCO	HADCO CORP
HAE	HAEMONETICS CORP
HAL	HALLIBURTON CO
HALO	HA-LO INDUSTRIES INC
HLX	HALTER MARINE GROUP INC
HQ	HAMBRECHT & QUIST GROUP
HABK	HAMILTON BANCORP INC
HKF	HANCOCK FABRICS INC
HBHC	HANCOCK HOLDING CO
HDL	HANDLEMAN & CO
HNH	HANDY & HARMAN
MAH	HANNA M A CO
HRD	HANNAFORD BROTHERS
HRBC	HARBINGER CORP
HARB	HARBOR FEDERAL SAVINGS BANK
H	HARCOURT GEN INC
HEC	HARKEN ENERGY CORP
HDI	HARLEY-DAVIDSON INC
HGIC	HARLEYSVILLE GROUP INC
HNBC	HARLEYSVILLE NATL CORP
HAR	HARMAN INTL INDUSTRIES INC
HPH	HARNISCHFEGER INDUSTRIES INC
HET	HARRAH'S ENTERTAINMENT INC
HRS	HARRIS CORP DEL
HARS	HARRIS SAVINGS BANK
HSC	HARSCO CORP
HHS	HARTE-HANKS COMMUNICATIONS CO
HLI	HARTFORD LIFE INC
HMX	HARTMARX CORP
HAS	HASBRO INC
HE	HAWAIIAN ELECTRIC INDUSTRIES
HAYS	HAYES WHEELS INTL INC
HBOC	HBO & CO
HCC	HCC INSURANCE HOLDINGS INC
HCIA	HCIA INC
HRP	HEALTH & RETIREMENT
HCR	HEALTH CARE & RETIREMENT CORP
HCN	HEALTH CARE REIT INC
HMA	HEALTH MGMT ASSOC INC
HCCC	HEALTHCARE COMPARE CORP
HCP	HEALTHCARE PROPERTY INVESTORS
HR	HEALTHCARE REALTY TRUST INC
HDTC	HEALTHDYNE TECHNOLOGIES INC
HPS	HEALTHPLAN SERVICES CORP
HS	HEALTHSOURCE INC
HRC	HEALTHSOUTH CORP
HTLD	HEARTLAND EXPRESS INC
HPRT	HEARTPORT INC
HL	HECLA MINING CO
HBCCA	HEFTEL BROADCASTING CORP
HMY	HEILIG-MEYERS CO
HELX	HELIX TECHNOLOGY CORP
HP	HELMERICH & PAYNE INC
HSIC	HENRY SCHEIN INC
HERB	HERBALIFE INTERNATIONAL INC
HPC	HERCULES INC
HERS	HERITAGE FINL SVCS I
HTG	HERITAGE MEDIA CORP
HSY	HERSHEY FOODS CORP
HRZ	HERTZ CORP
HWP	HEWLETT PACKARD CO
HXL	HEXCEL CORP
HFNC	HFNC FINANCIAL CORP
HFS	HFS INC
HIB	HIBERNIA CORP
HIC	HIGHLANDS INSURANCE GROUP
HWYM	HIGHWAYMASTER COMMUNICATIONS
HIW	HIGHWOOD PROPERTIES INC
HRH	HILB, ROGAL & HAMILTON CO
HB	HILLENBRAND INDUSTRIES INC
HLT	HILTON HOTELS CORP
HRSH	HIRSCH INTERNATIONAL CORP
HMTT	HMT TECHNOLOGY CORP
HNCS	HNC SOFTWARE INC
HLR	HOLLINGER INTERNATIONAL
HOC	HOLLY CORP
HLYW	HOLLYWOOD ENTERTAINMENT CORP
HPRK	HOLLYWOOD PARK INC
HOLX	HOLOGIC INC
HLPH	HOLOPHANE CORP
HD	HOME DEPOT INC
HME	HOME PROPERTIES OF NY INC
HSL	HOMESIDE INC
HM	HOMESTAKE MINING CO
HSD	HOMESTEAD VILLAGE INC
HONI	HON INDUSTRIES INC
HON	HONEYWELL INC
HMN	HORACE MANN EDUCATORS CORP
HGI	HORIZON GROUP INC
HHC	HORIZON/CMS HEALTHCARE CORP
HRL	HORMEL FOODS CORP
HPT	HOSPITALITY PROPERTIES TRUST
HMT	HOST MARRIOTT CORP
HMS	HOST MARRIOTT SERVICES CORP
HTN	HOUGHTON MIFFLIN CO
HI	HOUSEHOLD INTERNATIONAL INC
THX	HOUSTON EXPLORATION COMPANY
HOU	HOUSTON INDUSTRIES INC
HPRI	HPR INC
HSE	HS RESOURCES INC
HSB	HSB GROUP INC
HSNI	HSN INC
HUB	B HUBBELL INC
HUBC	HUBCO INC
HFI	HUDSON FOODS INC
HUF	HUFFY CORP
HUG	HUGHES SUPPLY INC
HUGO	HUGOTON ENERGY CORP
HGSI	HUMAN GENOME SCIENCES INC.
HUM	HUMANA INC
JBHT	HUNT JB TRANSPORT SERVICES INC
HUN	HUNT MANUFACTURING CO
HBAN	HUNTINGTON BANCSHARES INC
HTCH	HUTCHINSON TECHNOLOGY INC
HMAR	HVIDE MARINE INC
HYSW	HYPERION SOFTWARE CORP
ITWO	I2 TECHNOLOGIES INC
IBM	IBM CORP
IBP	IBP INC
IBSF	IBS FINANCIAL CORP
ICN	ICN PHARMACEUTICALS INC
ICOS	ICOS CORP
IDA	IDAHO POWER CO
IDPH	IDEC PHARMACEUTICALS CORP
IDX	IDENTIX INC
IEX	IDEX CORP
IDXX	IDEXX LABORATORIES INC
IDXC	IDX SYSTEMS CORP
IES	IES INDUSTRIES INC
IHOP	IHOP CORP
IKN	IKON OFFICE SOLUTIONS INC
IKOS	IKOS SYSTEMS INC
IC	ILLINOIS CENTRAL CORP
ITW	ILLINOIS TOOL WORKS INC
ILN	ILLINOVA CORPORATION
IMN	IMATION CORPORATION
IMAT	IMATRON INC
IGL	IMC GLOBAL INC
IMCC	IMC MORTGAGE CO
IMR	IMCO RECYCLING INC
IMNX	IMMUNEX CORP
IMMU	IMMUNOMEDICS INC
IMNT	IMNET SYSTEMS INC
IMP	IMPERIAL BANCORP
ICII	IMPERIAL CREDIT INDUSTRIES INC
IMH	IMPERIAL CREDIT MORTGAGE HLD
INFS	IN FOCUS SYSTEMS INC
INAC	INACOM CORP
INBR	INBRAND CORP
IPIA	INCYTE PHARMACEUTICALS INC
IEI	INDIANA ENERGY INC
IGRP	INDUS GROUP INC
IMIC	INDUSTRI-MATEMATIK INTL CORP
INFN	INFINITY FINANCIAL TECHNOLOGY
IMRS	INFORMATION MGMT RESOURCES INC
IRIC	INFORMATION RESOURCES INC
IFMX	INFORMIX CORP
IR	INGERSOLL RAND CO
IMKTA	INGLES MARKETS INC
IM	INGRAM MICRO INC
INHL	INHALE THERAPEUTIC SYSTEMS
IAD	INLAND STEEL INDUSTRIES INC
KPA	INNKEEPERS USA TRUST
INVX	INNOVEX INC
IO	INPUT/OUTPUT INC
IFS	INSIGNIA FINANCIAL GROUP
INSL	INSILCO CORP
INSO	INSO CORPORATION
IN	INTEGON CORP DEL
ICST	INTEGRATED CIRCUITS SYS INC
IDTI	INTEGRATED DEVICE TECHNOLOGY
IHS	INTEGRATED HEALTH SERVICES INC
IPEC	INTEGRATED PROCESS EQUIP CORP
INTS	INTEGRATED SYSTEMS INC
INTC	INTEL CORP
ICEL	INTERCEL INC
IDC	INTERDIGITAL COMMUNICATIONS
IFSIA	INTERFACE INC
INGR	INTERGRAPH CORP
IS	INTERIM SERVICES INC
ICIX	INTERMEDIA COMMUNICATIONS INC
INMT	INTERMET CORP
INDQA	INTERNATIONAL DAIRY QUEEN INC
FAM	INTERNATIONAL FAMILY
IGT	INTERNATIONAL GAME TECHNOLOGY
IMC	INTERNATIONAL MULTIFOODS
IP	INTERNATIONAL PAPER CO
IRF	INTERNATIONAL RECTIFIER CORP
ISP	INTERNATIONAL SPECIALTY
IPIC	INTERNEURON PHARMACEUTICAL INC
IPX	INTERPOOL INC
IPG	INTERPUBLIC GROUP COS INC
IFI	INTERRA FINANCIAL INC
ISLI	INTERSOLV
IBC	INTERSTATE BAKERIES CORP
IHC	INTERSTATE HOTELS COMPANY
IPW	INTERSTATE POWER CO
INTL	INTER-TEL INC
INTV	INTERVOICE INC
IWBK	INTERWEST BANCORP INC
IVAC	INTEVAC INC
IBI	INTIMATE BRANDS INC
IASI	INTL ALLIANCE SERVICES INC
IFF	INTL FLAVORS & FRAGRANCES INC
INSS	INTL NETWORK SERVICES
INTU	INTUIT INC
IVCR	INVACARE CORP
ITGI	INVESTMENT TECHNOLOGY GROUP
IFIN	INVESTORS FINANCIAL SVCS CORP
IOM	IOMEGA CORP
ION	IONICS INC
IPL	IPALCO ENTERPRISES
IMTN	IRON MOUNTAIN INC
IRT	IRT PROPERTY COMPANY
IAC	IRVINE APARTMENT COMMUNITIES
IRWN	IRWIN FINANCIAL CORP
ISIP	ISIS PHARMACEUTICALS INC
STAT	I-STAT
ITRI	ITRON INC
ITT	ITT CORP
ESI	ITT EDUCATIONAL SERVICES INC
IIN	ITT INDUSTRIES INC
IVX	IVAX CORP
IIXC	IXC COMMUNICATIONS INC
JCP	J C PENNEY INC
JPM	J P MORGAN & CO INC
JL	J&L SPECIALTY STEEL INC.
JBIL	JABIL CIRCUIT INC
JKHY	JACK HENRY & ASSOCIATES INC
JEC	JACOBS ENGINEERING GROUP INC
JCOR	JACOR COMMUNICATIONS INC
JR	JAMES RIVER CORP OF VIRGINIA
JDAS	JDA SOFTWARE GROUP INC
JDN	JDN REALTY CORP
JEF	JEFFERIES GROUP INC
JBNK	JEFFERSON BANKSHARES INC
JP	JEFFERSON PILOT CORP
JJSC	JEFFERSON SMURFIT CORP
JLG	JLG INDUSTRIES INC
JA	JOHN ALDEN FINANCIAL CORP
JH	JOHN H HARLAND CO
JNC	JOHN NUVEEN CO
JW	A JOHN WILEY & SONS INC
JM	JOHNS MANVILLE CORPORATION
JNJ	JOHNSON & JOHNSON
JCI	JOHNSON CONTROLS INC
JNY	JONES APPAREL GROUP INC
JOINA	JONES INTERCABLE INC
JMED	JONES MEDICAL INDUSTRIES INC
JOS	JOSTENS INC
JRC	JOURNAL REGISTER CO
JPF	JP FOODSERVICE INC
JPR	JP REALTY INC
JPMX	JPM COMPANY
JSBF	JSB FINANCIAL INC
JUNO	JUNO LIGHTING INC
FEET	JUST FOR FEET INC
JSTN	JUSTIN INDUSTRIES INC
KM	K MART CORP
KNE	K N ENERGY INC
KTO	K2 INC
KLU	KAISER ALUMINUM CORP
KAMNA	KAMAN CORP
KCLI	KANSAS CITY LIFE INSURANCE CO
KLT	KANSAS CITY POWER & LIGHT CO
KSU	KANSAS CITY SOUTHERN
KBH	KAUFMAN & BROAD HOME CORP
KDN	KAYDON CORP
KCS	KCS GROUP INC
KEA	KEANE INC
KOGC	KELLEY OIL & GAS CORP
K	KELLOGG CO
KWD	KELLWOOD CO
KELYA	KELLY SERVICES INC
KMET	KEMET CORP
KMT	KENNAMETAL INC
KCP	KENNETH COLE PRODUCTIONS
KNT	KENT ELECTRONICS CORP
KMG	KERR MCGEE CORP
KEG	KEY ENERGY GROUP INC
KEY	KEYCORP
KSTN	KEYSTONE FINANCIAL INC
KII	KEYSTONE INTERNATIONAL INC
KCC	K-III COMMUNICATIONS CORP
KRC	KILROY REALTY CORP
KBALB	KIMBALL INTERNATIONAL INC
KMB	KIMBERLY CLARK CORP
KIM	KIMCO REALTY CORP
KNCI	KINETIC CONCEPTS INC
KWP	KING WORLD PRODUCTIONS INC
KEX	KIRBY CORP
KTTY	KITTY HAWK INC
KFBI	KLAMATH FIRST BANCORP INC
KLAC	KLA-TENCOR CORP
KRI	KNIGHT RIDDER INC
KNGT	KNIGHT TRANSPORTATION INC
KNL	KNOLL INC
KE	KOGER EQUITY INC
KSS	KOHLS CORP
KMAG	KOMAG INC
KOSP	KOS PHARMACEUTICALS INC
KR	KROGER CO
KRON	KRONOS INC
KU	KU ENERGY CORP
KUH	KUHLMAN CORP
KLIC	KULICKE & SOFFA INDUSTRIES INC
KV	B K-V PHARMACEUTICAL CO
LQI	LA QUINTA INNS INC
LZB	LA Z BOY INC
LABS	LABONE INC
LH	LABORATORY CORP OF AMER HLDGS
LG	LACLEDE GAS CO
LAF	LAFARGE CORP
LLE	LAIDLAW ENVIRONMENTAL SVCS INC
LRCX	LAM RESEARCH CORP
LAMR	LAMAR ADVERTISING CO
LANC	LANCASTER COLONY CORP
LNCE	LANCE INC
LDR	LANDAUER INC
LDRY	LANDRY'S SEAFOOD RESTAURANTS
LE	LAND'S END INC
LSTR	LANDSTAR SYSTEM INC
LSCC	LATTICE SEMICONDUCTOR CORP
LAWS	LAWSON PRODUCTS INC
LAW	LAWTER INTERNATIONAL INC
LAYN	LAYNE INC
LCI	LCI INTERNATIONAL INC
LEA	LEAR CORPORATION
TLC	LEARNING COMPANY INC
LTRE	LEARNING TREE INTERNATIONAL
LRI	LEARONAL INC
LCRY	LECROY CORP
LEE	LEE ENTERPRISES INC
LGTO	LEGATO SYSTEMS INC
LM	LEGG MASON INC
LEG	LEGGETT & PLATT INC
LEH	LEHMAN BROTHERS HOLDING INC
LEN	LENNAR CORP
LUK	LEUCADIA NATIONAL CORP
LEVL	LEVEL ONE COMMUNICATIONS INC
LXK	LEXMARK INTL GROUP INC
LGE	LG&E ENERGY CORP
LHSG	LHS GROUP INC
LBY	LIBBEY INC
LC	LIBERTY CORP S C
L	LIBERTY FINANCIAL COMPANIES
LRY	LIBERTY PROPERTY TRUST
LIFB	LIFE BANCORP INC
LRE	LIFE RE CORP
LTEK	LIFE TECHNOLOGIES INC
LUSA	LIFE USA HOLDING INC
LGND	LIGAND PHARMACEUTICALS INC
LI	LILLY INDUSTRIES INC
LTD	LIMITED INC
LNTV	LIN TELEVISION CORP
LNCR	LINCARE HOLDINGS INC
LECOA	LINCOLN ELECTRIC CO
LNC	LINCOLN NATIONAL CORP INDIANA
LINZ	LINDSAY MANUFACTURING CO
LLTC	LINEAR TECHNOLOGY CORP
LIN	LINENS 'N THINGS INC
LIPO	LIPOSOME CO INC
LIQB	LIQUI-BOX CORP
LFUS	LITTELFUSE INC
LIT	LITTON INDUSTRIES INC
LCA	LIVING CENTERS OF AMERICA INC
LIZ	LIZ CLAIBORNE INC
LMT	LOCKHEED MARTIN CORPORATION
LTR	LOEWS CORP
LGN	LOGICON INC
LOJN	LO-JACK CORP
LOM	LOMAK PETE INC
LCE	LONE STAR INDS INC
STAR	LONE STAR STEAKHOUSE & SALOON
LSS	LONE STAR TECHNOLOGY INC
LBFC	LONG BEACH FINANCIAL CORP
LISB	LONG ISLAND BANCORP INC
LIL	LONG ISLAND LIGHTING CO
LDG	LONGS DRUG STORES INC
LFB	LONGVIEW FIBRE CO
LD	LOUIS DREYFUS NATURAL GAS
LLX	LOUISIANA LAND & EXPLORATION
LPX	LOUISIANA PACIFIC CORP
LOW	LOWES COMPANIES INC
LSI	LSI LOGIC CORP
LTC	LTC PROPERTIES INC
LTV	LTV CORP
LTXX	LTX CORP
LZ	LUBRIZOL CORP
LUB	LUBYS CAFETERIAS INC
LU	LUCENT TECHNOLOGIES INC
LUC	LUKENS INC
LUNR	LUNAR CORP
LCOS	LYCOS INC
LDL	LYDALL INC
LYO	LYONDELL PETROCHEMICAL CO
MSCA	M S CARRIERS INC
MFI	MAC FRUGALS BARGAINS CLOSE
MACD	MACDERMID INC
MAC	MACERICH COMPANY
MACR	MACROMEDIA INC
MDSN	MADISON GAS & ELECTRIC CO
MAFB	MAF BANCORP INC
MFO	MAFCO CONSOLIDATED GROUP INC
MGL	MAGELLAN HEALTH SERVICES INC
MGNL	MAGNA BANCORP INC
MGR	MAGNA GROUP INC
MAG	MAGNETEK INC
MAIL	MAIL BOXES ETC
MWL	MAIL-WELL INC
MSBC	MAINSTREET BANKGROUP INC
MBE	MALIBU ENTERTAINMENT WORLDWIDE
MKG	MALLINCKRODT INC
MTW	MANITOWOC CO INC
MNR	MANOR CARE INC
MAN	MANPOWER INC
MHC	MANUFACTURED HOME CMNTYS INC
MANU	MANUGISTICS GROUP INC
MDA	MAPCO INC
MCS	MARCUS CORP
MDCO	MARINE DRILLING COS INC
MRNR	MARINER HEALTH GROUP INC
IV	MARK IV INDUSTRIES INC
MKL	MARKEL CORP
MARQ	MARQUETTE MEDICAL SYS
MAR	MARRIOTT INTL INC
MMC	MARSH & MCLENNAN COMPANIES INC
MRIS	MARSHALL & ILSLEY CORP
MI	MARSHALL INDUSTRIES
MATK	MARTEK BIOSCIENCES CORP
MLM	MARTIN MARIETTA MATERIALS
MRV	MARVEL ENTERTAINMENT GROUP INC
MAS	MASCO CORP
MSX	MASCOTECH INC
MTZ	MASTEC INC
MAST	MASTECH CORP
MSC	MATERIAL SCIENCES CORP
MAT	MATTEL INC
MATW	MATTHEWS INTL CORP
MAVK	MAVERICK TUBE CORP
MAXI	MAXICARE HEALTH PLANS INC
MXIM	MAXIM INTEGRATED PRODUCTS INC
MXM	MAXXAM INC
SPEH	MAY & SPEH INC
MAY	MAY DEPT STORES CO
MYG	MAYTAG CORP
MBI	MBIA INC
KRB	MBNA CORP
MCAF	MCAFEE ASSOCIATES INC
MNI	MCCLATCHY NEWSPAPERS INC
MCCRK	MCCORMICK & CO
MDD	MCDONALD & CO INVESTMENTS, INC
MCD	MCDONALDS CORP
MD	MCDONNELL DOUGLAS CORP
MGRC	MCGRATH RENTCORP
MHP	MCGRAW HILL COMPANIES INC
MCIC	MCI COMMUNICATIONS CORP
MCK	MCKESSON CORP
MCLD	MCLEODUSA INC
MCN	MCN ENERGY GROUP INC
MWT	MCWHORTER TECHNOLOGIES
MDU	MDU RESOURCES GROUP INC
MEA	MEAD CORP
MIG	MEADOWBROOK INSURANCE GROUP
MEDA	MEDAPHIS CORP
MEG	A MEDIA GENERAL INC
MCSY	MEDIC COMPUTER SYSTEMS INC
MAI	MEDICAL ASSURANCE INC
MMGR	MEDICAL MANAGER CORP
MRII	MEDICAL RESOURCES INC
MDRX	MEDICIS PHARMACEUTICAL CORP
MEDI	MEDIMMUNE INC
MED	MEDIQ INC
MT	MEDITRUST SBI
MDM	MEDPARTNERS INC
MEDQ	MEDQUIST INC
MDT	MEDTRONIC INC
MSA	MEDUSA CORP
MEL	MELLON BANK CORP
MBRS	MEMBERWORKS INC
WFR	MEMC ELECTRONIC MATERIALS INC
SUIT	MENS WEARHOUSE INC
MNTR	MENTOR CORP
MENT	MENTOR GRAPHICS CORP
MTL	MERCANTILE BANCORP INC
MRBK	MERCANTILE BANKSHARES CORP
MST	MERCANTILE STORES CO INC
MBNY	MERCHANTS NEW YORK BANCORP
MRK	MERCK & CO INC
MFN	MERCURY FINANCE CO
MCY	MERCURY GENERAL CORP
MERQ	MERCURY INTERACTIVE CORP
MDP	MEREDITH CORP
MDN	MERIDIAN INDUSTRIAL TRUST INC
TMR	MERIDIAN RESOURCE CORP
MRLL	MERRILL CORP
MER	MERRILL LYNCH & CO INC
MRY	MERRY LAND & INVESTMENT INC
MXP	MESA INC
MAIR	MESABA HOLDINGS INC
MCC	MESTEK INC
METHA	METHODE ELECTRONICS
MTRS	METRIS COMPANIES INC
MISI	METRO INFORMATION SVCS INC
MTNT	METRO NETWORKS INC
ML	METROMAIL CORP
MMG	METROMEDIA INTL GROUP INC
METZ	METZLER GROUP INC
MGI	MGI PROPERTIES
MTG	MGIC INVESTMENT CORP WIS
MGG	MGM GRAND INC
MIKL	MICHAEL FOODS INC
MIKE	MICHAEL STORES INC
MCRL	MICREL INC
MLIN	MICRO LINEAR CORP
MWHS	MICRO WAREHOUSE INC
MICA	MICROAGE INC
MCHP	MICROCHIP TECHNOLOGY INC
MUEI	MICRON ELECTRONICS INC
MU	MICRON TECHNOLOGY INC
MCRS	MICROS SYSTEMS INC
MSFT	MICROSOFT CORP
MTSI	MICROTOUCH SYSTEMS INC
MIAM	MID AM INC
MME	MID ATLANTIC MEDICAL SERVICES
MAA	MID-AMER APARTMENT CMNTYS INC
MAB	MID-AMERICA BANCORP
MEC	MIDAMERICAN ENERGY HOLDINGS CO
MWY	MIDWAY GAMES INC
MEH	MIDWEST EXPRESS HOLDINGS INC
MKS	MIKASA INC
MCH	MILLENNIUM CHEMICALS INC
MLNM	MILLENNIUM PHARMACEUTICALS INC
MLHR	MILLER HERMAN INC
MLR	MILLER INDUSTRIES INC TENN
MIL	MILLIPORE CORP
MLS	MILLS CORP
MNES	MINE SAFETY APPLIANCES CO
MTX	MINERALS TECHNOLOGIES INC
MNMD	MINIMED INC
MMM	MINNESOTA MINING & MFG CO
MPL	MINNESOTA POWER & LIGHT CO
MIR	MIRAGE RESORTS INC
GRO	MISSISSIPPI CHEMICAL CORP
MVBI	MISSISSIPPI VALLEY BANCSHARES
MND	A MITCHELL ENERGY & DEV CORP
MLBC	ML BANCORP INC
MMI	MMI COMPANIES INC
MOB	MOBIL CORPORATION
MTEL	MOBILE TELECOMMUNICATION
MODI	MODINE MANUFACTURING CO
MOHK	MOHAWK INDUSTRIES INC
MOLX	MOLEX INC
MONE	MONEY STORES INC
MNE	MONEYGRAM PAYMENT SYSTEMS INC
MTC	MONSANTO CO
MTP	MONTANA POWER CO
MRC	MONTEREY RESOURCES INC
MOG	A MOOG INC
MOR	MORGAN KEEGAN INC
MWD	MORGAN STANLEY DEAN WITTER
MSTR	MORNINGSTAR GROUP INC
MHI	MORRISON HEALTH CARE INC
MK	MORRISON KNUDSEN CORP
MII	MORTON INTERNATIONAL INC
MOSI	MOSINEE PAPER CORP
MOPO	MOTIVEPOWER INDUSTRIES INC
MOT	MOTOROLA INC
MRVC	MRV COMMUNICATIONS INC
MSM	MSC INDUSTRIAL DIRECT CO
MTSC	MTS SYSTEMS CORP
MLI	MUELLER INDUSTRIES INC
MUL	MULTICARE COMPANIES INC
MUR	MURPHY OIL CORP
MYCO	MYCOGEN CORP
MYE	MYERS INDUSTRIES INC
MYL	MYLAN LABORATORIES
MYLX	MYLEX CORP
MYGN	MYRIAD GENETICS INC
NYT	A N Y TIMES CO
NABI	NABI INC
NA	NABISCO HOLDINGS CORP
NBR	NABORS INDUSTRIES INC
NRC	NAC RE CORPORATION
NC	NACCO INDUSTRIES INC
NLC	NALCO CHEMICAL CO
NAFC	NASH FINCH CO
NAK	NATIONAL AUTO CREDIT INC
FIZ	NATIONAL BEVERAGE CORP
NCBE	NATIONAL CITY BANCSHARES INC
NCC	NATIONAL CITY CORP
NCBC	NATIONAL COMMERCE BANCORP
NLCS	NATIONAL COMPUTER SYSTEMS INC
NDC	NATIONAL DATA CORP
NFG	NATIONAL FUEL GAS CO
TEE	NATIONAL GOLF PROPERTIES INC
NHI	NATIONAL HEALTH INVESTORS INC
NATI	NATIONAL INSTRUMENTS CORP
NM	NATIONAL MEDIA CORP
NPBC	NATIONAL PENN BANCSH
NPK	NATIONAL PRESTO IND
NAP	NATIONAL PROCESSING INC
NSM	NATIONAL SEMICONDUCTOR CORP
NSI	NATIONAL SERVICE INDUSTRIES
NS	NATIONAL STEEL CORP
NSCI	NATIONAL SURGERY CENTERS INC
TEAM	NATIONAL TECHTEAM INC
NWLIA	NATIONAL WESTERN LIFE INS CO
NOI	NATIONAL-OILWELL INC
NB	NATIONSBANK CORPORATION
NFS	NATIONWIDE FINANCIAL SERVICES
NHP	NATIONWIDE HEALTH PROPERTIES
NBAK	NATL BANCORP OF ALASKA INC
NMSS	NATURAL MICROSYSTEMS CORP
NATR	NATURES SUNSHINE PRODUCTS INC
NAUT	NAUTICA ENTERPRISES INC
NAV	NAVISTAR INTL CORP
NBTB	NBT BANCORP INC
NBTY	NBTY INC
NCH	NCH CORP
BLDG	NCI BUILDING SYSTEMS INC
NCOG	NCO GROUP INC
NCR	NCR CORPORATION
NCSS	NCS HEALTHCARE INC
NMG	NEIMAN-MARCUS GROUP INC
NELL	NELLCOR PURITAN BENNETT INC
NMGC	NEOMAGIC CORP
NPTH	NEOPATH INC
NEOP	NEOPROBE CORP
NSCP	NETSCAPE COMMUNICATIONS CORP
NTAP	NETWORK APPLIANCE INC
NCDI	NETWORK COMPUTING DEVICES INC
NWK	NETWORK EQUIPMENT TECHNOLOGIES
NETG	NETWORK GENERAL CORP
NXCO	NEUREX CORP
NRGN	NEUROGEN CORPORATION
NSIX	NEUROMEDICAL SYSTEMS INC
NVP	NEVADA POWER CO
NEB	NEW ENGLAND BUSINESS SERVICE
NES	NEW ENGLAND ELECTRIC SYSTEM
NJR	NEW JERSEY RESOURCES CORP
NPR	NEW PLAN REALTY TRUST SBI
NYB	NEW YORK BANCORP INC
NGE	NEW YORK STATE ELECTRIC & GAS
NWL	NEWELL CO
NFX	NEWFIELD EXPLORATION COMPANY
NGC	NEWMONT GOLD CO
NEM	NEWMONT MINING CORP
NR	NEWPARK RESOURCES
NNS	NEWPORT NEWS SHIPBUILDING INC
NXTR	NEXSTAR PHARMACEUTICALS INC
NXTL	NEXTEL COMMUNICATIONS INC
NFOR	NFO RESEARCH INC
NGL	NGC CORPORATION
NHPI	NHP INC
NMK	NIAGARA MOHAWK POWER CORP
NRES	NICHOLS RESEARCH CORP
GAS	NICOR INC
NKE	NIKE INC
NMBS	NIMBUS CD INTL INC
NIN	NINE WEST GROUP INC
NI	NIPSCO INC
NL	NL INDUSTRIES
NNBR	NN BALL & ROLLER INC
NBL	NOBLE AFFILIATES INC
NE	NOBLE DRILLING CORP
NAE	NORAM ENERGY CORP
NDSN	NORDSON CORP
NOBE	NORDSTROM INC
NSC	NORFOLK SOUTHERN CORP
NRL	NORRELL CORP
NTK	NORTEK INC
NAC	NORTH AMERICAN MTG CO
NCG	NORTH CAROLINA NATURAL GAS
TNFI	NORTH FACE INC
NFB	NORTH FORK BANCORPORATION INC
NPSI	NORTH PITTSBURGH SYSTEMS INC
NU	NORTHEAST UTILITIES
NSP	NORTHERN STATES POWER CO MINN
NTRS	NORTHERN TRUST CORP
NOC	NORTHROP GRUMMAN CORPORATION
NWAC	NORTHWEST AIRLINES CORP
NWNG	NORTHWEST NATURAL GAS CO
NPS	NORTHWESTERN PUBLIC SVC CO
NOB	NORWEST CORP
NIS	NOVA CORP/GEORGIA
NOV	NOVACARE INC
NOVL	NOVELL INC
NVLS	NOVELLUS SYSTEMS INC
NPCI	NPC INTERNATIONAL INC
NTLI	NTL INCORPORATED
NUS	NU SKIN ASIA PACIFIC INC
NUE	NUCOR CORP
NEV	NUEVO ENERGY CO
NUI	NUI CORP
NVR	NVR INC
NYM	NYMAGIC INC
NYN	NYNEX CORP
ORLY	O REILLY AUTOMOTIVE INC
OAK	OAK INDUSTRIES INC
OAKT	OAK TECHNOLOGY INC
OO	OAKLEY INC
OH	OAKWOOD HOMES CORP
OAS	OASIS RESIDENTIAL INC
ODIS	OBJECT DESIGN INC
OSII	OBJECTIVE SYSTEMS INTEGRATOR
OXY	OCCIDENTAL PETROLEUM CORP
OSYS	OCCUSYSTEMS INC
OEI	OCEAN ENERGY INC
OCFC	OCEAN FINANCIAL CORP
OII	OCEANEERING INTERNATIONAL INC
OCTL	OCTEL COMMUNICATIONS CORP
OCWN	OCWEN FINANCIAL CORP
ODSI	ODS NETWORKS INC
OEA	OEA INC
OXE	OEC MEDICAL SYSTEMS INC
ODP	OFFICE DEPOT INC
OMX	OFFICEMAX INC
OLOG	OFFSHORE LOGISTICS
OG	OGDEN CORP
OGE	OGE ENERGY CORP
OCAS	OHIO CASUALTY CORP
OEC	OHIO EDISON CO
OHM	OHM CORP
OVON	OIS OPTICAL IMAGING SYSTEM INC
OKEN	OLD KENT FINANCIAL CORP
OLDB	OLD NATIONAL BANCORP INDIANA
ORI	OLD REPUBLIC INTERNATIONAL
OLN	OLIN CORP
OLS	OLSTEN CORP
OMP	OM GROUP INC
OMEF	OMEGA FINANCIAL CORP
OHI	OMEGA HEALTHCARE INVESTORS INC
OMM	OMI CORP
OCR	OMNICARE INC
OMC	OMNICOM GROUP INC
OMPT	OMNIPOINT CORP
OMQP	OMNIQUIP INTL INC
ASGN	ON ASSIGNMENT INC
ONCO	ON COMMAND CORPORATION
ONBK	ONBANCORP INC
OV	ONE VALLEY BANCORP INC
OCQ	ONEIDA LTD
OKE	ONEOK INC
ONTK	ONTRAK SYSTEMS INC
OMKT	OPEN MARKET INC
OCCF	OPTICAL CABLE CORP
ORCL	ORACLE CORPORATION
ORU	ORANGE & ROCKLAND UTILITIES
ORBI	ORBITAL SCIENCES CORP
OREM	OREGON METALLURGICAL CORP
OS	OREGON STEEL MILLS INC
ORG	ORGANOGENESIS INC
OFG	ORIENTAL FINANCIAL GROUP
OC	ORION CAPITAL CORPORATION
OCAI	ORTHODONTIC CENTERS OF AMER
ORX	ORYX ENERGY COMPANY
GOSHA	OSHKOSH B'GOSH INC
OSM	OSMONICS INC
OSU	O'SULLIVAN INDUSTRIES HLDGS
OTTR	OTTER TAIL POWER
OSSI	OUTBACK STEAKHOUSE INC
OM	OUTBOARD MARINE CORP
OSIA	OUTDOOR SYSTEMS INC
OSG	OVERSEAS SHIPHOLDING GROUP INC
OAIC	OWEN ASSET INVESTMENT CORP
OMI	OWENS & MINOR INC
OWC	OWENS CORNING
OI	OWENS ILLINOIS INC
OXHP	OXFORD HEALTH PLANS INC
OXM	OXFORD INDUSTRIES
OXGN	OXIGENE INC
PCG	P G & E CORP
PPL	P P & L RESOURCES INC
PCAR	PACCAR INC
BOH	PACIFIC CENTURY FINANCIAL CORP
PET	PACIFIC ENTERPRISES INC
PGEX	PACIFIC GATEWAY EXCHANGE INC
GRY	PACIFIC GREYSTONE CORP
PAG	PACIFIC GULF PROPERTIES INC
PSUN	PACIFIC SUNWEAR CALIF INC
PHSYB	PACIFICARE HEALTH SYSTEMS
PPW	PACIFICORP
PMWI	PAGEMART WIRELESS INC
PAGE	PAGING NETWORK INC
PWJ	PAINE WEBBER GROUP INC
PAIR	PAIRGAIN TECHNOLOGIES INC
PLL	PALL CORP
PHHM	PALM HARBOR HOMES INC
PWIR	PALMER WIRELESS INC
SPOT	PANAMSAT CORPORATION
PVI	PANAVISION INC
PZZA	PAPA JOHN'S INTL INC
PLS	PARACELSUS HEALTHCARE CORP
PTB	PARAGON TRADE BRANDS INC
PMTC	PARAMETRIC TECHNOLOGY CORP
PRXL	PAREXEL INTERNATIONAL CORP
PKE	PARK ELECTROCHEMICAL CORP
PRK	PARK NATIONAL CORP
PDP	PARKER & PARSLEY PETROLEUM CO
PKD	PARKER DRILLING
PH	PARKER HANNIFIN CORP
PGNS	PATHOGENESIS CORP
PAH	PATRIOT AMERICAN HOSPITALITY
PDCO	PATTERSON DENTAL CO
PTEN	PATTERSON ENERGY INC
PAUH	PAUL HARRIS STORES
PXR	PAXAR CORP
PXN	PAXSON COMMUNICATIONS CORP
PAYX	PAYCHEX INC
PSS	PAYLESS SHOESOURCE INC
PCMS	P-COM INC
PDTI	PDT INC
IEC	PEC ISRAEL ECONOMIC CORP
PE	PECO ENERGY CO
PDX	PEDIATRIX MEDICAL GROUP INC
PEGA	PEGASYSTEMS INC
PNN	A PENN ENGINEERING & MFG CORP
PENN	PENN NATIONAL GAMING INC
PTAC	PENN TREATY AMERICAN CORP
PFG	PENNCORP FINANCIAL GROUP INC
PNT	PENNSYLVANIA ENTERPRISES INC
PEI	PENNSYLVANIA REAL ESTATE
PZL	PENNZOIL CO
SPWY	PENSKE MOTORSPORTS INC
PNR	PENTAIR INC
PBCT	PEOPLE'S BANK BRIDGEPORT CONN
PGL	PEOPLES ENERGY CORP
PFKY	PEOPLES FIRST CORP
PHBK	PEOPLES HERITAGE FINANCIAL
PSFT	PEOPLESOFT INC
PBY	PEP BOYS MANNY MOE & JACK
PEP	PEPSICO INC
PRCP	PERCEPTRON INC
PERC	PERCLOSE INC
PFGC	PERFORMANCE FOOD GROUP
PERI	PERIPHONICS CORPORATION
PKN	PERKIN ELMER CORP
PRGO	PERRIGO CO
PGA	PERSONNEL GROUP OF AMER INC
PETC	PETCO ANIMAL SUPPLIES INC
PLIT	PETROLITE CORP
PETM	PETSMART INC
PFFB	PFF BANCORP INC
PFE	PFIZER INC
PPDI	PHARMACEUTICAL PRODUCT DEVEL
PNU	PHARMACIA & UPJOHN INC
PD	PHELPS DODGE CORP
PHLY	PHILADELPHIA CONS HOLDING CO
PSC	PHILADELPHIA SUBURBAN CORP
MO	PHILIP MORRIS COMPANIES INC
P	PHILLIPS PETROLEUM CO
PVH	PHILLIPS VAN HEUSEN CORP
DUF	PHOENIX DUFF & PHELPS CORP
PTEC	PHOENIX TECHNOLOGIES LTD
PLAB	PHOTRONICS INC
PPH	PHP HEALTHCARE CORP
PHYC	PHYCOR INC
PHMX	PHYMATRIX INC
PCNI	PHYSICIAN COMPUTER NETWORK INC
PCAM	PHYSICIAN CORP OF AMERICA
PHYN	PHYSICIAN RELIANCE NETWORK INC
PSSI	PHYSICIAN SALES & SERVICE
PRG	PHYSICIANS RESOURCE GRP INC
PHYS	PHYSIO-CONTROL INTL CORP
PCTL	PICTURETEL CORP
PNY	PIEDMONT NATURAL GAS
PIR	PIER 1 IMPORTS INC
CHX	PILGRIMS PRIDE CORP
PTX	PILLOWTEX CORP
PRTL	PIMUS TELECOMMUNICATIONS GROUP
PKT	PINKERTONS INC
PNW	PINNACLE WEST CAPITAL CORP
PIOG	PIONEER GROUP INC
PHB	PIONEER HI-BRED INTERNATIONAL
PIOS	PIONEER STANDARD ELECTRONICS
PJC	PIPER JAFFRAY COS INC
PBI	PITNEY BOWES INC
PZB	PITTSTON BRINK'S GROUP
PZX	PITTSTON BURLINGTON GROUP
PRY	A PITTWAY CORP DEL
PIXR	PIXAR INC
PLX	PLAINS RESOURCES INC
PHII	PLANET HOLLYWOOD INTL INC
PLT	PLANTRONICS INC
PLAT	PLATINUM TECHNOLOGY INC
PLA	PLAYBOY ENTERPRISES INC
PYX	PLAYTEX PRODUCTS INC
PLXS	PLEXUS CORP
PGI	PLY-GEM INDUSTRIES INC
PMCS	PMC SIERRA INC
PMTS	PMT SERVICES INC
PNC	PNC BANK CORP
POBR	POE & BROWN INC
PPP	POGO PRODUCING CO
PII	POLARIS INDUSTRIES INC
PRD	POLAROID CORP
PMS	POLICY MANAGEMENT SYSTEMS CORP
PGH	POLYMER GROUP INC
PESC	POOL ENERGY SERVICES CO
POP	POPE & TALBOT INC
BPOP	POPULAR INC
PGN	PORTLAND GEN CORP
POSS	POSSIS MEDICAL INC
PPS	POST PROPERTIES INC
PCH	POTLATCH CORP
POM	POTOMAC ELECTRIC POWER CO
PWAV	POWERWAVE TECHNOLOGIES INC
PPG	PPG INDUSTRIES INC
PX	PRAXAIR INC
PCP	PRECISION CASTPARTS CORP
PRRC	PRECISION RESPONSE CORP
PMI	PREMARK INTL INC
PARK	PREMIER PARKS INC
PTEK	PREMIERE TECHNOLOGIES INC
PRMS	PREMISYS COMMUNICATIONS INC
PP	PRENTISS PROPERTIES TRUST
PPD	PRE-PAID LEGAL SERVICES INC
PLFE	PRESIDENTIAL LIFE CORP
PRST	PRESSTEK INC
PRIA	PRI AUTOMATION INC
TROW	PRICE (T.ROWE) ASSOCIATES INC
PREN	PRICE ENTERPRISES INC
PC	PRICELLULAR CORP
PRDE	PRIDE INTERNATIONAL INC
PRMA	PRIMADONNA RESORTS INC
PMK	PRIMARK CORP
PDQ	PRIME HOSPITALITY CORP
PMSI	PRIME MEDICAL SVCS INC
PRME	PRIME RETAIL INC
PRS	PRIME SERVICE INC
PG	PROCTER & GAMBLE CO
PRFT	PROFFITTS INC
PRGX	PROFIT RECOVERY GROUP INTL
PRGS	PROGRESS SOFTWARE CORP
PGR	PROGRESSIVE CORP OHIO
PSDI	PROJECT SOFTWARE & DEV INC
PRH	PROMUS HOTEL CORP
PL	PROTECTIVE LIFE CORP
PDLI	PROTEIN DESIGN LABS INC
PBKS	PROVIDENT BANKSHARES CORP
PVT	PROVIDENT COMPANIES INC
PFGI	PROVIDENT FINANCIAL GROUP
PVN	PROVIDIAN FINANCIAL CORP
PROX	PROXIM INC
PSIX	PSINET INC
PMD	PSYCHEMEDICS CORP
PNM	PUBLIC SERVICE CO
PSR	PUBLIC SERVICE CO OF COLORADO
PEG	PUBLIC SERVICES
PGS	PUBLIC SERVICES COMPANY NC INC
PSA	PUBLIC STORAGE INC
PRN	PUERTO RICAN CEMENT CO INC
PSD	PUGET SOUND ENERGY INC
PTZ	PULITZER PUBLISHING CO
PHM	PULTE CORP
PASW	PURE ATRIA CORP
PXT	PXRE CORP
OAT	QUAKER OATS CO
KSF	QUAKER STATE CORP
QCOM	QUALCOMM INC
XQ	QUALITY FOOD CENTERS INC
NX	QUANEX CORP
QNTM	QUANTUM CORP
QCSB	QUEENS COUNTY BANCORP INC
DGX	QUEST DIAGNOSTICS INC
STR	QUESTAR CORP
BQR	QUICK & REILLY GROUP INC
QRSI	QUICKRESPONSE SERVICES INC
QUIK	QUIKSILVER INC
QTEL	QUINTEL ENTERTAINMENT INC
QTRN	QUINTILES TRANSNATIONAL CORP
QHGI	QUORUM HEALTH GROUP INC
RLI	R L I CORP
DNY	R R DONNELLEY & SONS CO
RADS	RADIANT SYSTEMS INC
RSYS	RADISYS CORP
RAIN	RAINFOREST CAFE INC
RAH	RALCORP HOLDINGS INC
RAL	RALSTON-RALSTON PURINA GROUP
RMBS	RAMBUS INC
RMTR	RAMTRON INTERNATIONAL CORP
RAPT	RAPTOR SYSTEMS INC
RARE	RARE HOSPITALITY INTL INC
RATL	RATIONAL SOFTWARE CORP
RYC	RAYCHEM CORP
RAYM	RAYMOND CORP
RJF	RAYMOND JAMES FINANCIAL INC
RYN	RAYONIER INC
RTN	RAYTHEON CO
RCSB	RCSB FINANCIAL INC
RDA	READERS DIGEST ASSN INC
RB	READING & BATES CORP COM
RDRT	READ-RITE CORP
O	REALTY INCOME CORP
RA	RECKSON ASSOCIATES REALTY CORP
RRI	RED ROOF INNS INC
RWTI	REDWOOD TRUST INC
RBK	REEBOK INTERNATIONAL LTD
REGL	REGAL CINEMAS INC
RBC	REGAL-BELOIT CORP
RHS	REGENCY HEALTH SERVICES INC
REG	REGENCY REALTY CORP
REGN	REGENERON PHARMACEUTICAL INC
RGBK	REGIONS FINANCIAL CORP
RGIS	REGIS CORP MINN
REGI	REGISTRY INC
RGA	REINSURANCE GROUP AMER INC
RELY	RELIANCE BANCORP INC
REL	RELIANCE GROUP HOLDINGS INC
RS	RELIANCE STEEL & ALUMINUM CO
RLR	RELIASTAR FINANCIAL CORP
REMC	REMEC INC
RMDY	REMEDY CORP
RENS	RENAISSANCE SOLUTIONS INC
RCGI	RENAL CARE GROUP INC
RXT	RENAL TREATMENT CENTERS INC
RSV	RENTAL SERVICE CORP
RCII	RENTERS CHOICE INC
RBNC	REPUBLIC BANCORP INC
RGC	REPUBLIC GROUP INC
RII	REPUBLIC INDUSTRIES INC
RNB	REPUBLIC NEW YORK CORP
RSCR	RES-CARE INC
REMI	RESOURCE BANCSHARES MTG GRP
RESP	RESPIRONICS INC
REV	REVLON INC
RXSD	REXALL SUNDOWN INC
RXL	REXEL INC
RXN	REXENE CORP
REY	REYNOLDS & REYNOLDS CO
RLM	REYNOLDS METALS CO
RFS	RFS HOTEL INVESTORS INC
RPR	RHONE POULENC RORER INC
RFH	RICHFOOD HOLDINGS INC
RIGS	RIGGS NATIONAL CORP
RIT	RIGHTCHOICE MANAGED CARE INC
RHC	RIO HOTEL & CASINO INC
RSR	RISER FOODS INC
RCHI	RISK CAPITAL HOLDINGS INC
RAD	RITE AID CORP
RVFD	RIVIANA FOODS INC
RN	RJR NABISCO HOLDINGS CORP
RTI	RMI TITANIUM CO
ROAD	ROADWAY EXPRESS INC
ROBN	ROBBINS & MYERS INC
RHI	ROBERT HALF INTERNATIONAL INC
MOND	ROBERT MONDAVI CORP
RPC	ROBERTS PHARMACEUTICALS INC
ROBV	ROBOTIC VISION SYSTEMS INC
RGS	ROCHESTER GAS & ELECTRIC CORP
RSHX	ROCKSHOX INC
RKT	ROCK-TENN COMPANY
ROK	ROCKWELL INTL CRP
RSTI	ROFIN-SINAR TECHNOLOGIES INC
ROG	ROGERS CORP
ROH	ROHM & HAAS CO
RHR	ROHR INC
ROL	ROLLINS INC
RLC	ROLLINS TRUCK LEASING CORP
ROMC	ROMAC INTERNATIONAL INC
RFED	ROOSEVELT FINANCIAL GROUP INC
ROP	ROPER INDUSTRIES INC
RSLN	ROSLYN BANCORP INC
ROST	ROSS STORES INC
ROTC	ROTECH MEDICAL CORP
ROU	ROUGE STEEL COMPANY
RSE	ROUSE COMPANY
RDC	ROWAN COMPANIES INC
RAM	ROYAL APPLIANCE MFG CO
RES	RPC INC
RPOW	RPM INC OHIO
RBD	RUBBERMAID INC
RI	RUBY TUESDAY INC
RDK	RUDDICK CORP
RURL	RURAL/METRO CORP
RUS	RUSS BERRIE & CO INC
RML	RUSSELL CORP
RMOC	RUTHERFORD-MORAN OIL CORP
RYAN	RYANS FAMILY STEAK HOUSES INC
R	RYDER SYSTEMS INC
RT	RYERSON TULL INC
RYK	RYKOFF-SEXTON INC
STBA	S & T BANCORP INC
SIII	S3 INC
SBTK	SABRATEK CORP
TSG	SABRE GROUP HOLDINGS INC
SAFC	SAFECO CORP
SFE	SAFEGUARD SCIENTIFICS INC
SFSK	SAFESKIN CORP
SK	SAFETY KLEEN CORP
SWY	SAFEWAY INC
SGA	SAGA COMMUNICATIONS INC
SKS	SAKS HOLDINGS INC
SB	SALOMON INC
SAMC	SAMSONITE CORP
SAFM	SANDERSON FARMS INC
SNDK	SANDISK CORP
SANG	SANGSTAT MEDICAL CORP
SANM	SANMINA CORP
SABB	SANTA BARBARA BANCORP
SCOC	SANTA CRUZ OPERATION INC
SFR	SANTA FE ENERGY RESOURCES INC
SAPE	SAPIENT CORPORATION
SLE	SARA LEE CORP
BFS	SAUL CENTERS INC
SFI	SAVANNAH FOODS & INDS INC
SAWS	SAWTEK INC
SBA	SBARRO INC
SBC	SBC COMMUNICATIONS INC
SCG	SCANA CORP
SHR	SCHERER R P CORP DEL
SGP	SCHERING PLOUGH CORP
SCHL	SCHOLASTIC CORP
SHLM	SCHULMAN A INC
SCH	SCHWAB (CHARLES) CORP
SWM	SCHWEITZER MAUDUIT INTL
SCI	SCI SYSTEMS INC
SFA	SCIENTIFIC ATLANTA INC
SG	SCIENTIFIC GAMES HLDGS CORP
SCIO	SCIOS INC
SCOP	SCOPUS TECHNOLOGY INC
SCT	SCOTSMAN INDUSTRIES INC
SMG	SCOTTS CO
SKP	SCPIE HOLDINGS INC
SSP	SCRIPPS CO (E W)
SDLI	SDL INC
SEB	SEABOARD CORP DEL
SEAC	SEACHANGE INTERNATIONAL INC
CKH	SEACOR SMIT INC
SFLD	SEAFIELD CAPITAL CORP
SEG	SEAGATE TECHNOLOGY
SGO	SEAGULL ENERGY CORP
SEE	SEALED AIR CORP
S	SEARS ROEBUCK & CO
FOTO	SEATTLE FILMWORKS INC
SCN	SECURITY CAP INDUSTRIAL TR
SCA	SECURITY CAPITAL ATLANTIC INC
SECP	SECURITY CAPITAL CORP
PTR	SECURITY CAPITAL PACIFIC TRUST
SRC	SECURITY CONNECTICUT CORP
SDTI	SECURITY DYNAMICS TECH INC
SEIC	SEI INVESTMENTS CORP
SEI	SEITEL INC COM
SIGI	SELECTIVE INSURANCE GROUP
SMTC	SEMTECH INC
SRM	SENSORMATIC ELECTRONICS CORP
SEPR	SEPRACOR INC
SQA	A SEQUA CORP
SQNT	SEQUENT COMPUTER SYSTEMS INC
SEQU	SEQUUS PHARMACEUTICALS INC
SERO	SEROLOGICALS CORP
SRV	SERVICE CORP INTERNATIONAL
SVE	SERVICE EXPERTS INC
SME	SERVICE MERCHANDISE INC
SFXBA	SFX BROADCASTING INC
SMED	SHARED MEDICAL SYSTEMS CORP
SGR	SHAW GROUP INC
SHX	SHAW INDUSTRIES INC
SHEL	SHELDAHL INC
SHW	SHERWIN WILLIAMS CO
SHLO	SHILOH INDUSTRIES INC
SHVA	SHIVA CORP
SHN	SHONEYS INC
SKO	SHOPKO STORES INC
SHOR	SHOREWOOD PACKAGING CORP
SHBZ	SHOWBIZ PIZZA TIME INC
SBO	SHOWBOAT INC
SHU	SHURGARD STORAGE CENTERS
SEBL	SIEBEL SYSTEMS INC
SIE	SIERRA HEALTH SERVICES INC
SRP	SIERRA PACIFIC RESOURCES
SIG	SIG CORP INC
SIAL	SIGMA ALDRICH CORP
SIGR	SIGNATURE RESORTS INC
SBK	SIGNET BANKING CORP
SLGN	SILGAN HOLDINGS INC
SGI	SILICON GRAPHICS INC
SIVB	SILICON VALLEY BANCSHARES
SVGI	SILICON VALLEY GROUP INC
SILI	SILICONIX INC
SPG	SIMON DEBARTOLO GROUP INC
SMPS	SIMPSON INDUSTRIES INC
SMCO	SIMPSON MANUFACTURING CO INC
SBGI	SINCLAIR BROADCAST GROUP INC
SIPX	SIPEX CORPORATION
SWW	SITEL CORP
SKY	SKYLINE CORP
SMF	SMART & FINAL INC
SMOD	SMART MODULAR TECHNOLOGIES INC
SMTK	SMARTALK TELESERVICES INC
SMGS	SMECO ENERGY INC
AOS	SMITH A O CORP
SRW	SMITH CHARLES E RESIDENTIAL
SII	SMITH INTERNATIONAL INC
SFDS	SMITHFIELD FOODS INC
SFD	SMITH'S FOOD & DRUG CENTERS
SJM	A SMUCKER J M CO
SNA	SNAP-ON INC
SNC	SNYDER COMMUNICATIONS INC
SNY	SNYDER OIL CORP
SODK	SODAK GAMING INC
SDG	SOFAMOR/DANEK GROUP INC
SOL	SOLA INTERNATIONAL INC
SLR	SOLECTRON CORP
SNT	SONAT INC
SONC	SONIC CORP
SON	SONOCO PRODUCTS CORP
SNUS	SONUS PHARMACEUTICALS INC
BID	SOTHEBYS HOLDINGS INC
SRSV	SOURCE SERVICES CORP
SJI	SOUTH JERSEY INDUSTRIES INC
SDW	SOUTHDOWN INC
SCW	SOUTHERN CALIFORNIA WATER CO
SO	SOUTHERN CO
SNG	SOUTHERN NEW ENGLAND
SFC	SOUTHERN PACIFIC FUNDING CRP
PCU	SOUTHERN PERU COPPER CORP
SUG	SOUTHERN UNION CO
SLCM	SOUTHLAND CORP
SOTR	SOUTHTRUST CORP
LUV	SOUTHWEST AIRLINES CO
SWBT	SOUTHWEST BANCORP OF TEXAS INC
SWX	SOUTHWEST GAS CORP
SWN	SOUTHWESTERN ENERGY CO
SPS	SOUTHWESTERN PUBLIC SERVICE CO
SVRN	SOVEREIGN BANCORP INC
SSS	SOVRAN SELF STORAGE INC
SLMD	SPACELABS MEDICAL INC
SEH	SPARTECH CORP
SMCX	SPECIAL METALS CORP
SPEQ	SPECIALTY EQUIPMENT COS INC
SPCT	SPECTRIAN CORP
SBYT	SPECTRUM HOLOBYTE INC
SFAM	SPEEDFAM INTERNATIONAL INC
TRK	SPEEDWAY MOTORSPORTS INC
SP	SPELLING ENTERTAINMENT CORP
SPGLA	SPIEGEL INC
SPK	SPIEKER PROPERTIES INC
SPYN	SPINE TECH INC
SPLH	SPLASH TECHNOLOGY HOLDINGS INC
SMI	SPRINGS INDUSTRIES INC
FON	SPRINT CORP
ST	SPS TECHNOLOGIES INC
PAY	SPS TRANSACTION SERVICES INC
SPSS	SPSS INC
SPW	SPX CORP
STFR	ST FRANCIS CAPITAL CORP
SJP	ST JOE CORP
SJK	ST JOHN KNITS INC
STJ	ST JUDE MEDICAL INC
MARY	ST MARY LAND & EXPLORATION
SPBC	ST PAUL BANCORP INC
SPC	ST PAUL COMPANIES INC
STAA	STAAR SURGICAL CO
STAF	STAFFMARK INC
STGE	STAGE STORES INC
STND	STANDARD FINANCIAL INC
SMP	STANDARD MOTOR PRODUCTS INC
SPF	STANDARD PACIFIC CORP
SPD	STANDARD PRODUCTS CO
SR	STANDARD REGISTER
SXI	STANDEX INTERNATIONAL CORP
STII	STANFORD TELECOMMUNICATIONS
STH	STANHOME INC VTG
SWK	STANLEY WORKS
SPLS	STAPLES INC
STB	STAR BANC CORPORATION
SBUX	STARBUCKS CORP
SCX	STARRETT (L S) CO
STFC	STATE AUTO FINANCIAL CORP
STT	STATE STREET CORP
STN	STATION CASINOS INC
STEK	STECK-VAUGHN PUBLISHING CORP
STLD	STEEL DYNAMICS INC
SMRT	STEIN MART INC
SCL	STEPAN COMPANY
STRL	STERIS CORP
SBIB	STERLING BANCSHARES INC
SE	STERLING COMMERCE INC
SSW	STERLING SOFTWARE INC
SSSS	STEWART & STEVENSON SVCS INC
STEI	STEWART ENTERPRISES INC
SWC	STILLWATER MINING COMPANY
SW	STONE & WEBSTER INC
STO	STONE CONTAINER CORP
SGY	STONE ENERGY CORP
STK	STORAGE TECHNOLOGY CORP
SEA	STORAGE TRUST REALTY
SUS	STORAGE USA INC
SRA	STRATUS COMPUTER INC
STRWA	STRAWBRIDGE & CLOTHIER
STRA	STRAYER EDUCATION INC
SRR	STRIDE RITE CORP
SDRC	STRUCTURAL DYNAMICS RESEARCH
STRY	STRYKER CORP
STU	STUDENT LOAN CORP
SLM	STUDENT LOAN MARKETING ASSN
RGR	STURM RUGER & CO INC
SLAM	SUBURBAN LODGES OF AMERICA INC
SZA	SUIZA FOODS CORP
SUMI	SUMITOMO BK CALIF SAN FRAN
SUB	SUMMIT BANCORP
SMT	SUMMIT PROPERTIES INC
BEAM	SUMMIT TECHNOLOGY INC
SUI	SUN COMMUNITIES INC
SHG	SUN HEALTHCARE GROUP INC
SUN	SUN INC
SUNW	SUN MICROSYSTEMS INC
SAI	SUNAMERICA INC
SOC	SUNBEAM CORP
SNS	SUNDSTRAND CORP
SDS	SUNGARD DATA SYSTEMS INC
RAYS	SUNGLASS HUT INTERNATIONAL INC
SUNQ	SUNQUEST INFORMATION SYSTEMS
SNRZ	SUNRISE ASSISTED LIVING INC
SMD	SUNRISE MEDICAL INC
SSI	SUNSTONE HOTEL INVESTORS INC
STI	SUNTRUST BANKS INC
SUPC	SUPERIOR CONSULTANT HOLDINGS
SUP	SUPERIOR INDUSTRIES INTL INC
SUPR	SUPERIOR SERVICES INC
SUT	SUPERIOR TELECOM INC
SUPX	SUPERTEX INC
SVU	SUPERVALU INC
SUSQ	SUSQUEHANNA BANCSHARES INC PA
SFY	SWIFT ENERGY CO
SWFT	SWIFT TRANSPORTATION INC
SYBS	SYBASE INC
SYB	SYBRON CORP DEL
SYKE	SYKES ENTERPRISES INC
SLVN	SYLVAN LEARNING SYSTEMS INC
SYMC	SYMANTEC CORP
SBL	SYMBOL TECHNOLOGIES INC
SYMM	SYMMETRICOM INC
SYM	SYMS CORP
SNTC	SYNETIC INC
SNPS	SYNOPSYS INC
SNV	SYNOVUS FINANCIAL CORP
SIND	SYNTHETIC INDUSTRIES INC
SYY	SYSCO CORP
SSAX	SYSTEM SOFTWARE ASSOC INC
SCTC	SYSTEMS & COMPUTER TECHNOLOGY
SYSF	SYSTEMSOFT CORP
ROSE	T R FINANCIAL CORP
TLB	TALBOTS INC
TMB	TAMBRANDS INC
TDM	TANDEM COMPUTERS INC
TAN	TANDY CORP
SKT	TANGER FACTORY OUTLET CTRS INC
TCO	TAUBMAN CENTERS INC
TBCC	TBC CORP
TCAT	TCA CABLE TV INC
TCB	TCF FINANCIAL CORP
TSATA	TCI SATELLITE ENTERTAINMENT
TECD	TECH DATA CORP
TECH	TECHNE CORP
TNL	TECHNITROL INC
TSCC	TECHNOLOGY SOLUTIONS CO
TSY	TECH-SYM CORP
TCNL	TECNOL MEDICAL PRODUCTS INC
TE	TECO ENERGY INC
TECUA	TECUMSEH PRODUCTS CO
TEJ	TEJAS GAS CORP DEL
TRC	TEJON RANCH CO
TKLC	TEKELEC
TEK	TEKTRONIX INC
TCGX	TELCO COMMUNICATIONS GROUP
LBTYA	TELE COMMUNICATIONS INC - LIBERTY
TCOMA	TELE COMMUNICATIONS INC - TCI
TINTA	TELE COMMUNICATIONS INTL INC
TFX	TELEFLEX INC
TDS	TELEPHONE & DATA SYSTEMS INC
TCGI	TELEPORT COMMUNICATIONS GROUP
TLSP	TELESPECTRUM WORLDWIDE INC
TTEC	TELETECH HOLDINGS INC
TLAB	TELLABS INC
TALK	TEL-SAVE HOLDINGS INC
TLXN	TELXON CORPORATION
TIN	TEMPLE-INLAND INC
THC	TENET HEALTHCARE CORP
TANT	TENNANT CO
TEN	TENNECO INC
TER	TERADYNE INC
TEX	TEREX CORP
TRA	TERRA INDUSTRIES INC
TSO	TESORO PETROLEUM CORP
WATR	TETRA TECH INC
TTRA	TETRA TECHNOLOGIES INC DEL
TX	TEXACO INC
TXI	TEXAS INDUSTRIES INC
TXN	TEXAS INSTRUMENTS INC
TRBS	TEXAS REGIONAL BANCSHARES
TXU	TEXAS UTILITIES CO
TXT	TEXTRON INC
CGGI	THE CARBIDE/GRAPHITE GROUP INC
HIG	THE HARTFORD FINANCIAL
PMA	THE PMI GROUP INC
RET	THE PRICE REIT INC
RYL	THE RYLAND GROUP INC
TSA	THE SPORTS AUTHORITY INC
DIS	THE WALT DISNEY CO
THRX	THERAGENICS CORP
THRT	THERATECH INC UTAH
TDHC	THERMADYNE HOLDINGS CORP
TDX	THERMEDICS DETECTION INC
TMD	THERMEDICS INC
TCA	THERMO CARDIASYSTEMS INC
TCK	THERMO ECOTEK CORPORATION
TMO	THERMO ELECTRON CORP
TFT	THERMO FIBERTEK INC
THI	THERMO INSTRUMENT SYSTEMS INC
TOC	THERMO OPTEK COPR
TTT	THERMO TERRATECH INC
TLZ	THERMOLASE CORP
TMQ	THERMOQUEST CORPORATION
THS	THERMOSPECTRA CORP
TKN	THERMOTREX CORP
TKC	THIOKOL CORPORATION
TNB	THOMAS & BETTS CORP
TII	THOMAS INDUSTRIES INC
TNM	THOMAS NELSON INC
THO	THOR INDUSTRIES INC
TMA	THORNBURG MORTGAGE ASSET CORP
TKTM	TICKETMASTER GROUP INC
TDW	TIDEWATER INC
TIF	TIFFANY & CO
TIG	TIG HOLDINGS INC
TBL	TIMBERLAND CO
TWX	TIME WARNER INC
TMC	TIMES MIRROR CO
TKR	TIMKEN CO
TEXP	TITAN EXPLORATION INC
TH	TITAN HOLDINGS INC
TWI	TITAN INTERNATIONAL INC
TIMT	TITANIUM METALS CORP
TJCO	TJ INTERNATIONAL INC
TJX	TJX COMPANIES INC
TMPW	TMP WORLDWIDE INC
TNP	TNP ENTERPRISES INC
TOL	TOLL BROTHERS INC
TR	TOOTSIE ROLL INDUSTRIES INC
TOPP	TOPPS CO INC
TMK	TORCHMARK CORP
TTC	TORO CO
TOS	TOSCO CORP
TRL	TOTAL RENAL CARE HOLDINGS
TSS	TOTAL SYSTEMS SERVICES INC
TWR	TOWER AUTOMOTIVE INC
TCT	TOWN & COUNTRY TRUST
TBZ	TOY BIZ INC
TOY	TOYS R US INC
TTRR	TRACOR INC
TSCO	TRACTOR SUPPLY COMPANY
TRFI	TRANS FINANCIAL INC
TWA	TRANS WORLD AIRLINES INC
TNSI	TRANSACTION NETWORK SERVICES
TSAI	TRANSACTION SYSTEMS ARCHITECTS
TA	TRANSAMERICA CORP
TRH	TRANSATLANTIC HOLDINGS INC
TSIX	TRANSITION SYSTEMS INC
THY	TRANSITIONAL HOSPITALS CORP
TKTX	TRANSKARYOTIC THERAPIES INC
TMG	TRANSMONTAIGNE OIL CO
RIG	TRANSOCEAN OFFSHORE INC
TTXG	TRANSTEXAS GAS CORP
TRV	TRAVELERS GROUP INC
TAP	TRAVELERS PROP CASUALTY CORP
TG	TREDEGAR INDUSTRIES INC
TRE	TREMONT CORPORATION
TREN	TRENWICK GROUP INC
TXM	TREX MEDICAL CORP
TGIC	TRIAD GUARANTY INC
TRBC	TRIANGLE BANCORP INC
TRIP	TRIANGLE PACIFIC CORP
VIRS	TRIANGLE PHARMACEUTICALS INC
TRY	TRIARC COMPANY INC
TRB	TRIBUNE CO
TMAR	TRICO MARINE SERVICES INC
TRID	TRIDENT MICROSYSTEMS INC
TGN	TRIGEN ENERGY CORP
TGH	TRIGON HEALTHCARE INC
TMS	TRIMAS CORP
TRMB	TRIMBLE NAVIGATION LTD
TRI	TRINET CORPORATE REALTY TR INC
TRN	TRINITY INDUSTRIES INC
TQNT	TRIQUINT SEMICONDUCTOR INC
TGI	TRIUMPH GROUP INC
TNO	TRUE NORTH COMMUNICATIONS
DJT	TRUMP HOTELS & CASINO RESORT
TCNJ	TRUST COMPANY OF N J
TRST	TRUSTCO BANK CORP N Y
TRMK	TRUSTMARK CORP
TRW	TRW INC
TUBO	TUBOSCOPE VETCO INTL CORP
TEP	TUCSON ELECTRIC POWER CO
TUES	TUESDAY MORNING CORP
TTX	TULTEX CORP
TUP	TUPPERWARE CORP
TRBO	TURBOCHEF INC
TWLB	TWINLAB CORP
TYC	TYCO INTERNATIONAL LTD
TYSNA	TYSON FOODS INC
USBC	U S BANCORP
UBS	U S BIOSCIENCE INC
UH	U S HOME CORP
USLD	U S LONG DISTANCE CORP
USR	U S RENTALS INC
USTC	U S TRUST CORP
USW	U S WEST INC
UMG	U S WEST INC - MEDIA GROUP
USI	U.S. INDUSTRIES INC
UAL	UAL CORP
UCR	UCAR INTERNATIONAL INC
UGI	UGI CORP
UGLY	UGLY DUCKLING CORP
UICI	UICI
UDS	ULTRAMAR DIAMOND SHAMROCK CORP
UTEK	ULTRATECH STEPPER INC
UMBF	UMB FINANCIAL CORP
UNC	UNC INC
UCM	UNICOM CORP
UFI	UNIFI INC
UNF	UNIFIRST CORP
UCC	UNION CAMP CORP
UK	UNION CARBIDE CORP
UEP	UNION ELECTRIC CO
UNP	UNION PACIFIC CORP
UPR	UNION PACIFIC RESOURCES GROUP
UPC	UNION PLANTERS CORP
UTH	UNION TEXAS PETROLEUM HOLDINGS
UNBC	UNIONBANCAL CORPORATION
UNPH	UNIPHASE CORP
UWW	UNISOURCE WORLDWIDE INC
UIS	UNISYS CORP
UNT	UNIT CORP
UAM	UNITED ASSET MANAGEMENT CORP
UAG	UNITED AUTO GROUP INC
UBSI	UNITED BANKSHARES INC
UCAR	UNITED CAROLINA BANCSHARES
UCIT	UNITED CITIES GAS CO
UC	UNITED COMPANIES FINANCIAL
UDR	UNITED DOMINION REALTY TRUST
UFCS	UNITED FIRE & CASUALTY CO
UNH	UNITED HEALTHCARE CORP
UIL	UNITED ILLUMINATING CO
UIHIA	UNITED INTERNATIONAL HLDGS
UMC	UNITED MERIDIAN CORP
UNFI	UNITED NATURAL FOODS INC
USM	UNITED STATES CELLULAR CORP
USF	UNITED STATES FILTER CORP
USS	UNITED STATES SURGICAL CORP
USTR	UNITED STATIONERS INC
UTX	UNITED TECHNOLOGIES CORP
UTVI	UNITED TELEVISION INC
UVSGA	UNITED VIDEO SATELLITE GRP
UWST	UNITED WASTE SYSTEMS INC
UWR	UNITED WATER RESOURCES INC
UWZ	UNITED WIS SVCS INC
UTOG	UNITOG CO
UNIT	UNITRIN INC
UTR	UNITRODE CORP
UVV	UNIVERSAL CORP
UFC	UNIVERSAL FOODS CORP
UFPI	UNIVERSAL FOREST PRODUCTS
UHT	UNIVERSAL HEALTH REALTY INCOME
UHS	UNIVERSAL HEALTH SERVICES
UOUT	UNIVERSAL OUTDOOR HOLDINGS INC
UVN	UNIVISION COMMUNICATIONS INC
UCL	UNOCAL CORP
UNRI	UNR INDUSTRIES INC
UNM	UNUM CORP
URBN	URBAN OUTFITTERS INC
URB	URBAN SHOPPING CENTERS INC
U	US AIRWAYS GROUP INC
UBAN	US BANCORP INC
USC	US CAN CORP
OFIS	US OFFICE PRODUCTS CO
USSB	US SATELLITE BROADCASTING CO
USAD	USA DETERGENTS INC
UW	USA WASTE SERVICES INC
USCS	USCS INTERNATIONAL INC
FG	USF&G CORP
USFC	USFREIGHTWAYS CORPORATION
USG	USG CORP
USTB	UST CORP
UST	UST INC
MRO	USX-MARATHON GROUP
X	USX-U.S. STEEL GROUP
UCU	UTILICORP UNITED INC
VFC	V F CORP
MTN	VAIL RESORTS INC
VCI	VALASSIS COMMUNICATIONS INC
VLNC	VALENCE TECHNOLOGY INC
VLO	VALERO ENERGY CORP
VHI	VALHI CORP
VLY	VALLEY NATIONAL BANCORP
VALM	VALMONT INDUSTRIES INC
VAL	VALSPAR CORP
VCD	VALUE CITY DEPARTMENT STORES
VH	VALUE HEALTH INC
VALU	VALUE LINE INC
VJET	VALUJET INC
VCELA	VANGUARD CELLULAR SYSTEMS INC
VST	VANSTAR CORP
VNTV	VANTIVE CORP
VRC	VARCO INTL INC
VAR	VARIAN ASSOCIATES INC
VRI	VASTAR RESOURCES INC
VECO	VEECO INSTRUMENTS INC
VC	VENCOR INC
VTS	VERITAS DGC INC
VRTS	VERITAS SOFTWARE CORP
VFSC	VERMONT FINANCIAL SERVICES
VRTX	VERTEX PHARMACEUTICALS INC
VTA	VESTA INSURANCE GROUP INC
VCAI	VETERINARY CENTERS AMER INC
VIA	B VIACOM INC
VVI	VIAD CORP
VIAS	VIASOFT INC
VICL	VICAL INC
VICR	VICOR CORP
VSVR	VIDEOSERVER INC
VIEW	VIEWLOGIC SYSTEMS INC
VKNG	VIKING OFFICE PRODUCTS INC
VCAM	VINCAM GROUP INC
VPI	VINTAGE PETE INC
VSH	VISHAY INTERTECHNOLOGY INC
VSIO	VISIO CORP
VSTN	VISTANA INC
VISX	VISX INC DEL
VITL	VITAL SIGNS INC
VTK	VITALINK PHARMACY SERVICES INC
VTSS	VITESSE SEMICONDUCTOR CORP
VVUS	VIVUS INC
VLSI	VLSI TECHNOLOGY INC
VOL	VOLT INFORMATION SCIENCES
VNO	VORNADO REALTY TRUST
VMC	VULCAN MATERIALS CO
VWRX	VWR SCIENTIFIC PRODUCTS CORP
GWW	W W GRAINGER INC
GRA	W.R. GRACE & CO
WBN	WABAN INC
WNC	WABASH NATIONAL CORP
WB	WACHOVIA CORP
WAK	WACKENHUT CORP
WHC	WACKENHUT CORRECTIONS CORP
WALB	WALBRO CORPORATION
WDN	WALDEN RESIDENTIAL PROPERTIES
WAG	WALGREEN COMPANY
WALK	WALKER INTERACTIVE SYSTEMS INC
WALL	WALL DATA INC
WCS	WALLACE COMPUTER SERVICES INC
WMT	WAL-MART STORES INC
WLTR	WALTER INDUSTRIES INC
WANG	WANG LABORATORIES INC
WAC	WARNACO GROUP INC
WLA	WARNER LAMBERT CO
WFSL	WASHINGTON FEDERAL INC
WGL	WASHINGTON GAS LIGHT CO
WAMU	WASHINGTON MUTUAL INC
WNT	WASHINGTON NATIONAL CORP
WPO	WASHINGTON POST CO
WRE	WASHINGTON REAL ESTATE
WWP	WASHINGTON WATER POWER COMPANY
WMX	WASTE MANAGEMENT INC
WAT	WATERS CORP
WJ	WATKINS JOHNSON CO
WSO	WATSCO INC
WATS	WATSON PHARMACEUTICALS INC
WTS	WATTS INDS INC
WSAU	WAUSAU PAPER MILLS CO
WAVR	WAVERLY INC
WDFC	WD 40 COMPANY
WII	WEATHERFORD ENTERRA INC
WBB	WEBB DEL CORP
WBST	WEBSTER FINANCIAL CORP
WKS	WEEKS CORP
WRI	WEINGARTEN REALTY INVESTORS
WMK	WEIS MARKETS INC
WLM	WELLMAN INC
WLP	WELLPOINT HEALTH NETWORKS INC
WFC	WELLS FARGO & CO
WEN	WENDYS INTERNATIONAL INC
WERN	WERNER ENTERPRISES INC
WSBC	WESBANCO INC
WSC	WESCO FINANCIAL CORP
WJCO	WESLEY JESSEN VISIONCARE INC
WCBO	WEST COAST BANCORP
WST	WEST INC
WMAR	WEST MARINE INC
WTSC	WEST TELESERVICES CORP
WABC	WESTAMERICA BANCORP
WES	WESTCORP INC
WSTL	WESTELL TECHNOLOGIES INC
WAI	WESTERN ATLAS INC
WDC	WESTERN DIGITAL CORP
WGR	WESTERN GAS RESOURCE INC
WIR	WESTERN INVESTMENT REAL ESTATE
WNH	WESTERN NATIONAL CORP
WR	WESTERN RES INC
WWCA	WESTERN WIRELESS CORP
WBPR	WESTERNBANK PUERTO RICO
WEA	WESTFIELD AMERICA INC
WAB	WESTINGHOUSE AIR BRAKE CO
WX	WESTINGHOUSE ELECTRIC CO
WPSN	WESTPOINT STEVENS INC
W	WESTVACO CORP
WONE	WESTWOOD ONE INC
WTSLA	WET SEAL INC
WY	WEYERHAEUSER CO
WFSI	WFS FIANANCIAL INC
WTI	WHEELABRATOR TECHNOLOGIES INC
WHR	WHIRLPOOL CORP
WHRC	WHITE RIVER CORP
WH	WHITMAN CORP
WTNY	WHITNEY HOLDING CORP
WHIT	WHITTMAN-HART INC
WFMI	WHOLE FOODS MARKET INC
WIC	WICOR INC
WWY	WILLIAM WRIGLEY JR CO
WLL	WILLIAMETTE INDUSTRIES INC
WMB	WILLIAMS COS INC
WSGC	WILLIAMS-SONOMA INC
WLMR	WILMAR INDUSTRIES INC
WILM	WILMINGTON TRUST CORP
WIND	WIND RIVER SYSTEMS INC
WND	WINDMERE-DURABLE HOLDINGS INC
WIN	WINN DIXIE STORES INC
WGO	WINNEBAGO INDUSTRIES INC
WCII	WINSTAR COMMUNICATIONS INC
WINN	WINSTON HOTELS INC
WTT	WIRELESS TELECOM GROUP INC
WCLX	WISCONSIN CENTRAL TRANS CORP
WEC	WISCONSIN ENERGY CORP
WIT	WITCO CORP
WMS	WMS INDUSTRIES
WLV	WOLVERINE TUBE INC
WWW	WOLVERINE WORLD WIDE
WNDR	WONDERWARE CORP
WDHD	WOODHEAD INDUSTRIES INC
WGOV	WOODWARD GOVERNOR CO
Z	WOOLWORTH CORPORATION
WAXS	WORLD ACCESS INC
WRC	WORLD COLOR PRESS INC
WCOM	WORLDCOM INC
WFDS	WORTHINGTON FOODS INC
WTHG	WORTHINGTON INDUSTRIES INC
WPH	WPL HOLDINGS INC
WPS	WPS RESOURCES CORP
WSFS	WSFS FINANCIAL CORP
WYL	WYLE ELECTRONICS
WYMN	WYMAN GORDON COMPANY
WYN	WYNDHAM HOTEL CORP
WN	WYNNS INTERNATIONAL INC
XRX	XEROX CORP
XLNX	XILINX INC
XIRC	XIRCOM
XRIT	X-RITE INC
XTR	XTRA CORP
XYLN	XYLAN CORP
YHOO	YAHOO! INC
YES	YANKEE ENERGY STSTEM INC
YELL	YELLOW CORP
YRK	YORK INTERNATIONAL CORP
YBTVA	YOUNG BROADCASTING CORP
YURI	YURIE SYSTEMS INC
ZLC	ZALE CORP
ZBRA	ZEBRA TECHNOLOGIES CORP
ZEI	ZEIGLER COAL HOLDING CO
ZE	ZENITH ELECTRONICS CORP
ZNT	ZENITH NATIONAL INSURANCE CORP
ZRO	ZERO CORP
ZILA	ZILA INC
ZLG	ZILOG INC
ZION	ZIONS BANCORPORATION
ZITL	ZITEL CORP
ZOLT	ZOLTEX COS INC
ZRAN	ZORAN CORP
ZRC	ZURICH REINS CENTRE HLDGS INC
ZRN	ZURN INDUSTRIES INC
ZIGO	ZYGO CORP
ZTEC	ZYTEC CORP
