AAON	AAON INC
AIR	AAR CORP
ABCB	ABC BANCORP
ABXA	ABX AIR INC
ACMR	A C MOORE ARTS & CRAFTS
ADCT	ADC TELECOMMUNICATIONS
ADEX	ADE CORP
ABM	ABM INDUSTRIES INC
AFCE	AFC ENTERPRISES INC
AFL	AFLAC INC
AG	AGCO CORP
ATG	AGL RESOURCES INC
AES	AES CORP
AKS	AK STEEL HOLDING CORP
AMB	AMB PROPERTY CORP
AMCS	AMICAS INC
AML	AMLI RESIDENTIAL PPTYS
AHS	AMN HEALTHCARE SERVICES
AMR	AMR CORP
T	AT&T CORP
ASVI	A S V INC
ATMI	ATMI INC
ATPG	ATP OIL & GAS CORP
AVX	AVX CORP
RNT	AARON RENTS INC
AIC	AAMES INVESTMENT CORP
ASTM	AASTROM BIOSCIENCES INC
ABAX	ABAXIS INC
ABT	ABBOTT LABORATORIES
ANF	ABERCROMBIE & FITCH
ABGX	ABGENIX INC
ABMD	ABIOMED INC
ACAD	ACADIA PHARMACEUTICALS
AKR	ACADIA REALTY TRUST
LEND	ACCREDITED HOME LENDERS
ACDO	ACCREDO HEALTH INC
ACW	ACCURIDE CORP
AACE	ACE CASH EXPRESS INC
ATVI	ACTIVISION INC
ACTL	ACTEL CORP
ATU	ACTUANT CORP
AYI	ACUITY BRANDS INC
ACXM	ACXIOM CORP
ADPT	ADAPTEC INC
ADZA	ADEZA BIOMEDICAL CORP
KAR	ADESA INC
ASF	ADMINISTAFF INC
ADBE	ADOBE SYSTEMS INC
ADLR	ADOLOR CORP
ADTN	ADTRAN INC
AEA	ADVANCE AMERICA CASH ADV
AAP	ADVANCE AUTO PARTS INC
ADIC	ADVANCED DIGITAL INFO
ANSI	ADVANCED NEUROMODULATION
AD	ADVO INC
ABCO	ADVISORY BOARD CO
EYE	ADVANCED MEDICAL OPTICS
ARXX	AEROFLEX INC
ARO	AEROPOSTALE INC
AMD	ADVANCED MICRO DEVICES
ADVNB	ADVANTA CORP
AEISE	ADVANCED ENERGY INDS INC
ADVS	ADVENT SOFTWARE INC
AET	AETNA INC
ACS	AFFILIATED COMPUTER SVCS
AMG	AFFILIATED MANAGERS GRP
AFFX	AFFYMETRIX INC
AFFM	AFFIRMATIVE INSURANCE
ARC	AFFORDABLE RESIDENTIAL
ATAC	AFTERMARKET TECHNOLOGY
AGR	AGERE SYSTEMS INC
A	AGILENT TECHNOLOGIES INC
AGIL	AGILE SOFTWARE CORP
AGYS	AGILYSYS INC
ADC	AGREE REALTY CORP
APD	AIR PRODS & CHEMS INC
ARG	AIRGAS INC
AAI	AIRTRAN HOLDINGS INC
AIRN	AIRSPAN NETWORKS INC
AKAM	AKAMAI TECHNOLOGIES
ALAB	ALABAMA NATIONAL BANCORP
ALG	ALAMO GROUP INC
APCS	ALAMOSA HOLDINGS INC
ALK	ALASKA AIR GROUP INC
ALSK	ALASKA COMMUNICATIONS
AIN	ALBANY INTERNATIONAL
AMRI	ALBANY MOLECULAR RESRCH
ALB	ALBEMARLE CORP
ACV	ALBERTO CULVER CO
ABS	ALBERTSONS INC
AA	ALCOA INC
AWGI	ALDERWOODS GROUP INC
ARS	ALERIS INTERNATIONAL INC
ALEX	ALEXANDER & BALDWIN INC
ALX	ALEXANDERS INC
ARE	ALEXANDRIA REAL ESTATE
ALXN	ALEXION PHARMACEUTICALS
ALFA	ALFA CORP
ALCO	ALICO INC
ALGN	ALIGN TECHNOLOGY INC
ALKS	ALKERMES INC
Y	ALLEGHANY CORP
AYE	ALLEGHENY ENERGY INC
ATI	ALLEGHENY TECHNOLOGIES
AGN	ALLERGAN INC
ALE	ALLETE INC
ADS	ALLIANCE DATA SYSTEMS
AGI	ALLIANCE GAMING CORP
AIQ	ALLIANCE IMAGING INC
AOI	ALLIANCE ONE INTL INC
LNT	ALLIANT ENERGY CORP
ATK	ALLIANT TECHSYSTEMS
ALD	ALLIED CAPITAL CORP
AHCI	ALLIED HEALTHCARE INTL
AW	ALLIED WASTE INDUSTRIES
AFC	ALLMERICA FINANCIAL CORP
ALOY	ALLOY INC
MDRX	ALLSCRIPTS HEALTHCARE
ALL	ALLSTATE CORP
AT	ALLTEL CORP
ANR	ALPHA NATURAL RESOURCES
ALO	ALPHARMA INC
ALTR	ALTERA CORP
ATRS	ALTIRIS INC
MO	ALTRIA GROUP INC
AMZN	AMAZON COM INC
ABK	AMBAC FINANCIAL GRP INC
EPAX	AMBASSADORS GROUP INC
ACO	AMCOL INTERNATIONAL CORP
AMED	AMEDISYS INC
ABNK	AMEGY BANCORPORATION INC
AHC	AMERADA HESS CORP
UHAL	AMERCO
AEE	AMEREN CORP
ASGR	AMERICA SERVICE GROUP
AWA	AMERICA WEST HLDG CORP
AMFI	AMCORE FINANCIAL INC
AXL	AMERICAN AXLE & MFG
ACC	AMERICAN CAMPUS COMMUN
ACAS	AMERICAN CAP STRATEGIES
ADPI	AMERICAN DENTAL PARTNERS
ECOL	AMERICAN ECOLOGY CORP
AEP	AMERICAN ELECTRIC POWER
AEOS	AMERICAN EAGLE OUTFITTER
AEL	AMERICAN EQUITY INVST
AXP	AMERICAN EXPRESS CO
AFG	AMERICAN FINANCIAL GROUP
AFR	AMERICAN FINANCIAL RLTY
AM	AMERICAN GREETINGS
AMHC	AMERICAN HEALTHWAYS INC
AHM	AMERICAN HOME MTG INVS
AIG	AMERICAN INTL GROUP
PLB	AMERICAN ITALIAN PASTA
AMMD	AMERICAN MEDICAL SYSTEMS
ANAT	AMERICAN NATIONAL INS CO
APPX	AMERICAN PHARMA PARTNERS
ACAP	AMERICAN PHYSICIANS CAP
ACR	AMERICAN RETIREMENT CORP
APCC	AMERICAN PWR CONVERSION
ARP	AMERICAN REPROGRAPHICS
ASEI	AMERICAN SCIENCE & ENGR
ASD	AMERICAN STD COS INC
AWR	AMERICAN STATES WATER CO
AMT	AMERICAN TOWER CORP
AMSC	AMERICAN SUPERCONDUCTOR
AVD	AMERICAN VANGUARD CORP
AMWD	AMERICAN WOODMARK CORP
AWBC	AMERICANWEST BANCORP
ACF	AMERICREDIT CORP
CRMT	AMERICAS CAR-MART INC
ASCA	AMERISTAR CASINOS INC
AMN	AMERON INTERNATIONAL INC
AMH	AMERUS GROUP CO
ABC	AMERISOURCEBERGEN CORP
AGP	AMERIGROUP CORP
AMTD	AMERITRADE HOLDING CORP
ATLO	AMES NATIONAL CORP
AME	AMETEK INC
AMGN	AMGEN INC
AMIS	AMIS HOLDINGS INC
AMKR	AMKOR TECHNOLOGY INC
APH	AMPHENOL CORP
ASO	AMSOUTH BANCORP
AMSG	AMSURG CORP
AMLN	AMYLIN PHARMACEUTICALS
APC	ANADARKO PETROLEUM CORP
ADI	ANALOG DEVICES INC
ALOG	ANALOGIC CORP
ANEN	ANAREN INC
ABCW	ANCHOR BANCORP INC
ANDE	ANDERSONS INC
ANDW	ANDREW CORP
ADRX	ANDRX GROUP
AGL	ANGELICA CORP
ANGO	ANGIODYNAMICS INC
BUD	ANHEUSER BUSCH COS INC
PUMP	ANIMAS CORP
AXE	ANIXTER INTERNATIONAL
NLY	ANNALY MORTAGE MGMT INC
ANN	ANNTAYLOR STORES CORP
ANST	ANSOFT CORP
ANSS	ANSYS INC
ANT	ANTEON INTERNATIONAL
AHR	ANTHRACITE CAPITAL INC
AGEN	ANTIGENICS INC
ANH	ANWORTH MORTGAGE ASSET
AOC	AON CORP
APA	APACHE CORP
AIV	APARTMENT INVT & MGMT
APOG	APOGEE ENTERPRISES INC
APOL	APOLLO GROUP INC
AINV	APOLLO INVESTMENT CORP
AAPL	APPLE COMPUTER INC
APPB	APPLEBEES INTERNATIONALAHG APRIA HEALTHCARE GROUP
ABI	APPLERA CORP APPLIED
CRA	APPLERA CORP CELERA
ADSX	APPLIED DIGITAL SOLUTION
AFCO	APPLIED FILMS CORP
AIT	APPLIED INDUSTRIAL TECH
AMAT	APPLIED MATLS INC
AMCC	APPLIED MICRO CIRCUITS
APSG	APPLIED SIGNAL TECH
ATR	APTARGROUP INC
WTR	AQUA AMERICA INC
AQNT	AQUANTIVE INC
ILA	AQUILA INC
RMK	ARAMARK CORP
ARBX	ARBINET-THEXCHANGE INC
ARB	ARBITRON INC
ABR	ARBOR REALTY TRUST INC
ARJ	ARCH CHEMICALS INC
ACI	ARCH COAL INC
ADM	ARCHER DANIELS MIDLAND
AX	ARCHIPELEGO HOLDINGS INC
ASN	ARCHSTONE SMITH TRUST
ACAT	ARCTIC CAT INC
ARDNA	ARDEN GROUP INC
ARI	ARDEN REALTY INC
ARNA	ARENA PHARMACEUTICALS
ARCC	ARES CAP CORP
STST	ARGON ST INC
AGII	ARGONAUT GROUP INC
AGY	ARGOSY GAMING CO
ARIA	ARIAD PHARMACEUTICALS
ARBA	ARIBA INC
ABFS	ARKANSAS BEST CORP
AH	ARMOR HOLDINGS INC
ARQL	ARQULE INC
ARRS	ARRIS GROUP INC
ARRY	ARRAY BIOPHARMA INC
ARW	ARROW ELECTRONICS INC
AROW	ARROW FINANCIAL CORP
ARRO	ARROW INTERNATIONAL INC
ATSN	ARTESYN TECHNOLOGIES INC
ARTC	ARTHROCARE CORP
ARM	ARVINMERITOR INC
ABG	ASBURY AUTOMOTIVE GROUP
AHT	ASHFORD HOSPITALITY
ASH	ASHLAND INC
ASKJ	ASK JEEVES INC
ASIA	ASIAINFO HOLDINGS INC
ASPM	ASPECT MEDICAL SYSTEMS
ASPT	ASPECT COMMUNICATIONS
AZPN	ASPEN TECHNOLOGY INC
AACC	ASSET ACCEPTANCE CAPITAL
ASBC	ASSOCIATED BANC CORP
AIZ	ASSURANT INC
ASFI	ASTA FDG INC
ASTE	ASTEC INDUSTRIES INC
AF	ASTORIA FINANCIAL CORP
ASYT	ASYST TECHNOLOGIES INC
ATAR	ATARI INC
AGIX	ATHEROGENICS INC
ATHR	ATHEROS COMMUNICATIONS
ATLS	ATLAS AMER INC
ATML	ATMEL CORP
ATO	ATMOS ENERGY CORP
ATW	ATWOOD OCEANICS INC
ADBL	AUDIBLE INC
VOXX	AUDIOVOX CORP
AUGT	AUGUST TECHNOLOGY CORP
ABTL	AUTOBYTEL INC
ADSK	AUTODESK INC
ALV	AUTOLIV INC
ADP	AUTOMATIC DATA PROCESS
AN	AUTONATION INC
AZO	AUTOZONE INC
AVB	AVALONBAY CMNTYS INC
AVN	AVANIR PHARMACEUTICALS
AVTR	AVATAR HOLDINGS INC
AV	AVAYA INC
AVY	AVERY DENNISON CORP
AVL	AVIALL INC
AVID	AVID TECHNOLOGY INC
AVA	AVISTA CORP
AVT	AVNET INC
AVCT	AVOCENT CORP
AVP	AVON PRODUCTS INC
ACLS	AXCELIS TECHNOLOGIES INC
AZR	AZTAR CORP
BBT	BB&T CORP
BFCF	BFC FINANCIAL CORP
BEIQ	BEI TECHNOLOGIES INC
BSG	BISYS GROUP INC
BJS	BJ SERVICES CO
BKF	BKF CAP GROUP INC
BJ	BJS WHOLESALE CLUB INC
BOKF	BOK FINANCIAL CORP
BRE	BRE PROPERTIES INC
BMC	BMC SOFTWARE INC
BMI	BADGER METER INC
BHI	BAKER HUGHES INC
BCP	BALCHEM CORP
BEZ	BALDOR ELECTRIC CO
BWINB	BALDWIN & LYONS INC
BLL	BALL CORP
TBNC	BANC CORP
BANF	BANCFIRST CORP
BXS	BANCORPSOUTH INC
TBBK	BANCORP INC
BTFG	BANCTRUST FINANCIAL GRP
BDG	BANDAG INC
BAC	BANK OF AMERICA CORP
GRAN	BANK OF GRANITE CORP
BOH	BANK OF HAWAII CORP
BKMU	BANK MUTUAL CORP
OZRK	BANK OF THE OZARKS INC
BK	BANK OF NEW YORK CO INC
BBX	BANKATLANTIC BANCORP
RATE	BANKRATE INC
BKUNA	BANKUNITED FINANCIAL
BANR	BANNER CORP
BN	BANTA CORPBCR BARD C R INC
BKS	BARNES & NOBLE INC
B	BARNES GROUP INC
BRL	BARR PHARMACEUTICALS INC
BBG	BILL BARRETT CORP
BTRX	BARRIER THERAPEUTICS INC
BSET	BASSETT FURNITURE IND
BOL	BAUSCH & LOMB INC
BAX	BAXTER INTERNATIONAL INC
BEAV	BE AEROSPACE INC
BEAS	BEA SYSTEMS INC
BECN	BEACON ROOFING SUPPLY
BSC	BEAR STEARNS COS INC
BE	BEARINGPOINT INC
BBGI	BEASLEY BROADCAST GROUP
BZH	BEAZER HOMES USA INC
BEBE	BEBE STORES INC
BEC	BECKMAN COULTER INC
BDX	BECTON DICKINSON & CO
BBBY	BED BATH & BEYOND INC
BED	BEDFORD PROPERTY INVS
BELFB	BEL FUSE INC
BDC	BELDEN CDT INC
BELM	BELL MICROPRODUCTS INC
BLS	BELLSOUTH CORP
BLC	BELO CORP
BMS	BEMIS INC
BHE	BENCHMARK ELECTRONICS
BNT	BENTLEY PHARMACEUTICALS
BER	BERKLEY W R CORP
BHL	BERKSHIRE HILLS BANCORP
BRY	BERRY PETROLEUM CO
BBY	BEST BUY INC
BEV	BEVERLY ENTERPRISES
BHBC	BEVERLY HILLS BANCORP
BGFVE	BIG 5 SPORTING GOODS
BLI	BIG LOTS INC
BMM	BIMINI MORTGAGE MGMT INC
BIO	BIO-RAD LABORATORIES INC
BRLI	BIO-REFERENCE LABS INC
BIVNE	BIOENVISION INC
BMET	BIOMET INC
BMRN	BIOMARIN PHARMACEUTICAL
BIIB	BIOGEN IDEC INC
BMR	BIOMED REALTY TRUST INC
BIOS	BIOSCRIP INC
BSTE	BIOSITE INC
BDK	BLACK & DECKER CORP
BJRI	BJS RESTAURANTS INC
BBOX	BLACK BOX CORP
BBBB	BLACKBOARD INC
BKH	BLACK HILLS CORP
BLKB	BLACKBAUD INC
BLK	BLACKROCK INC
BL	BLAIR CORP
HRB	BLOCK H & R INC
BBI	BLOCKBUSTER INC
BLT	BLOUNT INTERNATIONAL INC
BCSI	BLUE COAT SYSTEMS INC
NILE	BLUE NILE INC
BXG	BLUEGREEN CORP
BXC	BLUELINX HOLDINGS INC
BTH	BLYTH INC
BOBE	BOB EVANS FARMS INC
BA	BOEING CO
BDE	BOIS D ARC ENERGY INC
BONT	BON-TON STORES INC
BBA	BOMBAY CO INC
BCII	BONE CARE INTERNATIONAL
BGP	BORDERS GROUP INC
BWA	BORG WARNER INC
BORL	BORLAND SOFTWARE CORP
SAM	BOSTON BEER INC
BPFH	BOSTON PRIVATE FINANCIAL
BXP	BOSTON PROPERTIES INC
BSX	BOSTON SCIENTIFIC CO
EPAY	BOTTOMLINE TECHNOLOGIES
BOW	BOWATER INC
BNE	BOWNE & CO INC
BYD	BOYD GAMING CORP
BOY	BOYKIN LODGING CO
BRC	BRADY CORP
BDN	BRANDYWINE REALTY TRUST
BGG	BRIGGS & STRATTON CO
BEXP	BRIGHAM EXPLORATION
BFAM	BRIGHT HORIZON FAMILY
CELL	BRIGHTPOINT INC
EAT	BRINKER INTERNATIONAL
BCO	BRINKS CO
BMY	BRISTOL MYERS SQUIBB
BRW	BRISTOL WEST HLDGS INC
BRCM	BROADCOM CORP
BWNG	BROADWING CORPORATION
BRCDE	BROCADE COMMUNICATIONS
BHS	BROOKFIELD HOMES CORP
BRKL	BROOKLINE BANCORP INC
BRKS	BROOKS AUTOMATION INC
BKST	BROOKSTONE INC
BRO	BROWN & BROWN INC
BF.B	BROWN FORMAN CORP
BWS	BROWN SHOE INC
BRKR	BRUKER BIOSCIENCES CORP
BC	BRUNSWICK CORP
BW	BRUSH ENGINEERED MAT
BKI	BUCKEYE TECHNOLOGIES INC
BKE	BUCKLE INC
BUCY	BUCYRUS INTERNATIONAL
BWLD	BUFFALO WILD WINGS INC
BBW	BUILD A BEAR WORKSHOP
BMHC	BUILDING MATLS HLDG
BCF	BURLINGTON COAT FACTORY
BNI	BURLINGTON NORTHERN
BR	BURLINGTON RESOURCES INC
CHP	C&D TECHNOLOGIES INC
CBL	CBL & ASSOC PPTYS INC
CCCG	CCC INFORMATION SVCS
CBRL	CBRL GROUP INC
CBG	CB RICHARD ELLIS GROUP
CCBL	C COR INC
CDI	CDI CORPCDWC CDW CORP
CEC	CEC ENTMT INC
CHG	CH ENERGY GROUP INC
CHRW	C H ROBINSON WORLDWIDE
CI	CIGNA CORP
CIT	CIT GROUP INC
CKR	CKE RESTAURANTS INC
CNL	CLECO CORP
CKXE	CKX INC
CMGI	CMGI INC
CMS	CMS ENERGY CORP
CSS	CSS INDUSTRIES INC
CAO	CSK AUTO CORP
CNA	CNA FINANCIAL CORP
SUR	CNA SURETY CORP
CNF	CNF INC
CNXS	CNS INC
CNET	CNET NETWORKS INC
CRAI	CRA INTERNATIONAL INC
CSGS	CSG SYSTEMS INTL INC
CSX	CSX CORP
CTCI	CT COMMUNICATIONS INC
CTS	CTS CORP
CUNO	CUNO INC
CVBF	CVB FINANCIAL CORP
CVS	CVS CORP
CVTX	CV THERAPEUTICS INC
CAB	CABELAS INC
CVC	CABLEVISION SYSTEMS CORP
CBT	CABOT CORP
COG	CABOT OIL & GAS CORP
CCMP	CABOT MICROELECTRONICS
CACH	CACHE INC
CAI	CACI INTERNATIONAL INC
CDN	CADENCE DESIGN SYSTEMS
CDIS	CAL DIVE INTERNATIONAL
CLMS	CALAMOS ASSET MGMT INC
CCC	CALGON CARBON CORP
CALC	CALIFORNIA COASTAL CMNTY
CPKI	CALIFORNIA PIZZA KITCHEN
CWT	CALIFORNIA WTR SVC GRP
CALP	CALIPER LIFE SCIENCES
ELY	CALLAWAY GOLF CO
CPE	CALLON PETROLEUM CO
CPN	CALPINE CORP
CBM	CAMBREX CORP
CAC	CAMDEN NATIONAL CORP
CPT	CAMDEN PROPERTY TRUST
CPB	CAMPBELL SOUP CO
CLZR	CANDELA CORP
CMN	CANTEL MEDICAL CORP
CCBG	CAPITAL CITY BANK GROUP
CARS	CAPITAL AUTOMOTIVE REIT
CCOW	CAPITAL CORP OF THE WEST
CAPX	CAPITAL CROSSING BK
LSE	CAPITAL LEASE FUNDING
COF	CAPITAL ONE FINANCIAL
CSWC	CAPITAL SOUTHWEST CORP
CT	CAPITAL TRUST INC
CSE	CAPITALSOURCE INC
CBC	CAPITOL BANCORP LTD
CFFN	CAPITOL FEDERAL FINL
CPD	CARACO PHARMACEUTICAL
CRR	CARBO CERAMICS INC
CSAR	CARAUSTAR INDUSTRIES INC
CFNL	CARDINAL FINANCIAL CORP
CAH	CARDINAL HEALTH INC
CECO	CAREER EDUCATION CORP
CMX	CAREMARK RX INC
CSL	CARLISLE COS INC
KMX	CARMAX INC
CKEC	CARMIKE CINEMAS INC
CRS	CARPENTER TECHNOLOGY
CRE	CARRAMERICA REALTY CORP
CRZO	CARRIZO OIL & GAS INC
CRI	CARTER INC
CACB	CASCADE BANCORP
CAE	CASCADE CORP
CGC	CASCADE NATURAL GAS CORP
CWST	CASELLA WASTE SYSTEMS
CASY	CASEYS GENERAL STORES
CSH	CASH AMERICA INTL INC
CAS	CASTLE A M & CO
CMRG	CASUAL MALE RETAIL GROUP
POS	CATALINA MARKETING CORP
CATT	CATAPULT COMMUNICATIONS
CDX	CATELLUS DEV CORP
CAT	CATERPILLAR INC
CATY	CATHAY GENERAL BANCORP
CTR	CATO CORP
CDR	CEDAR SHOPPING CTRS INC
CE	CELANESE CORP
CEGE	CELL GENESYS INC
CTIC	CELL THERAPEUTICS INC
CELG	CELGENE CORP
CD	CENDANT CORP
CYCL	CENTENNIAL COMM CORP
CNC	CENTENE CORP
CLFC	CENTER FINANCIAL CORP
CNT	CENTERPOINT PPTYS TRUST
CNP	CENTERPOINT ENERGY INC
CTX	CENTEX CORP
CCBN	CENTRAL COAST BANCORP
CEDC	CENTRAL EUROPEAN DISTRIB
CENT	CENTRAL GARDEN & PET CO
CPF	CENTRAL PACIFIC FINL
CPC	CENTRAL PARKING CORP
CV	CENTRAL VERMONT PUB SVC
CENX	CENTURY ALUMINUM CO
CBIZ	CENTURY BUSINESS SVC
CTL	CENTURYTEL INC
CEPH	CEPHALON INC
CPHD	CEPHEID INC
CVO	CENVEO INC
CRDN	CERADYNE INC
CERG	CERES GROUP INC
CEN	CERIDIAN CORP
CERN	CERNER CORP
CEY	CERTEGY INC
CHB	CHAMPION ENTERPRISES INCCTHR CHARLES & COLVARD LTD
CRL	CHARLES RIVER LABS INTL
CHC	CHARTERMAC
CHIC	CHARLOTTE RUSSE HLDG
CHRS	CHARMING SHOPPES INC
CHTR	CHARTER COMMUNICATIONS
CHFN	CHARTER FINANCIAL CORP
CHTT	CHATTEM INC
CKFR	CHECKFREE CORP
CKP	CHECKPOINT SYSTEMS INC
CAKE	CHEESECAKE FACTORY INC
CHE	CHEMED CORPORATION
CHFC	CHEMICAL FINANCIAL CORP
LNG	CHENIERE ENERGY INC
CHKE	CHEROKEE INC
CSK	CHESAPEAKE CORP
CHK	CHESAPEAKE ENERGY CORP
CVX	CHEVRON CORP
CME	CHICAGO MERCANTILE HLDGS
CHS	CHICOS FAS INC
PLCE	CHILDRENS PLACE RETAIL
CESV	CHINA ENERGY TECHNOLOGY
CHH	CHOICE HOTELS INTL INC
CQB	CHIQUITA BRANDS INTL INC
CHIR	CHIRON CORP
CHZ	CHITTENDEN CORP
CPS	CHOICEPOINT INC
CBK	CHRISTOPHER & BANKS CORP
CB	CHUBB CORP
CHD	CHURCH & DWIGHT INC
CHDN	CHURCHILL DOWNS INC
CBR	CIBER INC
CIEN	CIENA CORP
XEC	CIMAREX ENERGY CO
CBB	CINCINNATI BELL INC
CINF	CINCINNATI FINANCIAL
CIN	CINERGY CORP
CC	CIRCUIT CITY STORES INC
CIR	CIRCOR INTERNATIONAL INC
CRUS	CIRRUS LOGIC INC
CSCO	CISCO SYSTEMS INC
CDL	CITADEL BROADCASTING
CTAS	CINTAS CORP
CZNC	CITIZENS & NORTHERN CORP
C	CITIGROUP INC
CTRN	CITI TRENDS INC
CBCF	CITIZENS BANKING CORP
CZN	CITIZENS COMMUNICATIONS
CIA	CITIZENS INC
CTXS	CITRIX SYSTEMS INC
CTBK	CITY BANK
CHCO	CITY HOLDING CO
CYN	CITY NATIONAL CORP
CLE	CLAIRES STORES INC
CLC	CLARCOR INC
CLK	CLARK INC
CLHB	CLEAN HARBORS INC
CCU	CLEAR CHANNEL COMM INC
CLF	CLEVELAND CLIFFS INC
CKCM	CLICK COMMERCE INC
CSBK	CLIFTON SVGS BANCORP INC
CLX	CLOROX CO
COH	COACH INC
COA	COACHMEN INDUSTRIES INC
CFCP	COASTAL FINANCIAL CORP
COBZ	COBIZ INC
COKE	COCA COLA BOTTLING
KO	COCA COLA CO
CCE	COCA COLA ENTERPRISE
CDE	COEUR D ALENE MINES CORP
COI	COGENT COMMUNICATIONS
COGT	COGENT INC
CGNX	COGNEX CORP
CTSH	COGNIZANT TECH SOLUTIONS
COHR	COHERENT INC
CNS	COHEN & STEERS INC
COHU	COHU INC
CSTR	COINSTAR INC
CWTR	COLDWATER CREEK INC
KCP	COLE KENNETH PRODTNS
CL	COLGATE PALMOLIVE CO
CFSI	COLLEGIATE FUNDING SVCS
CNB	COLONIAL BANCGROUP INC
CLP	COLONIAL PROPERTIES TR
CBAN	COLONY BANKCORP INC
CLRK	COLOR KINETICS INC
CBMD	COLUMBIA BANCORP
COLB	COLUMBIA BKG SYSTEM INC
COLM	COLUMBIA SPORTSWEAR CO
FIX	COMFORT SYSTEMS USA INC
CMCSA	COMCAST CORP
CMA	COMERICA INC
CBH	COMMERCE BANCORP INC
CBSH	COMMERCE BANCSHARES INC
CGI	COMMERCE GROUP INC
CLBK	COMMERCIAL BANKSHARES
CCBI	COMMERCIAL CAP BANCORP
CFB	COMMERCIAL FEDERAL CORP
CMC	COMMERCIAL METALS CO
NNN	COMMERCIAL NET LEASE
CVGI	COMMERCIAL VEHICLE GROUP
CTCO	COMMONWEALTH TEL ENT
CTV	COMMSCOPE INC
CBON	COMMUNITY BANCORP
CBU	COMMUNITY BANK SYSTEMS
CMTY	COMMUNITY BANKS INC
CYH	COMMUNITY HEALTH SYSTEMS
CTBI	COMMUNITY TRUST BANCORP
CBSS	COMPASS BANCSHARES INC
CMP	COMPASS MINERALS INTL
CCRT	COMPUCREDIT CORP
CA	COMPUTER ASSOCIATES INTL
CPSI	COMPUTER PROGRAMS & SYS
CSC	COMPUTER SCIENCES CORP
CPWR	COMPUWARE CORP
CIX	COMPX INTERNATIONAL
CHCI	COMSTOCK HOMEBUILDING
CRK	COMSTOCK RESOURCES INC
CITP	COMSYS IT PARTNERS INC
CMTL	COMTECH TELECOMMCMVT COMVERSE TECHNOLOGY
CAG	CONAGRA FOODS INC
CNQR	CONCUR TECHNOLOGIES INC
CNXT	CONEXANT SYSTEMS INC
CNMD	CONMED CORP
CTWS	CONNECTICUT WATER SVC
CNCT	CONNETICS CORP
CONN	CONNS INC
COP	CONOCOPHILLIPS
CONR	CONOR MEDSYSTEMS INC
CNO	CONSECO INC
CNX	CONSOL ENERGY INC
ED	CONSOLIDATED EDISON INC
CGX	CONSOLIDATED GRAPHIC
CTO	CONSOLIDATED TOMOKA LAND
STZ	CONSTELLATION BRANDS
CEG	CONSTELLATION ENERGY GRP
CAL	CONTINENTAL AIRLINES INC
CVG	CONVERGYS CORP
CAM	COOPER CAMERON CORP
COO	COOPER COMPANIES INC
CTB	COOPER TIRE & RUBBER CO
CPRT	COPART INC
COCO	CORINTHIAN COLLEGES INC
CRXA	CORIXA CORP
CPO	CORN PRODS INTERNATIONAL
GLW	CORNING INC
EXBD	CORPORATE EXECUTIVE
OFC	CORPORATE OFFICE PPTYS
CPV	CORRECTIONAL PPTYS TRUST
CXW	CORRECTIONS CORP OF AMER
CORS	CORUS BANKSHARES INC
CRVL	CORVEL CORP
CPWM	COST PLUS INC
COST	COSTCO WHOLESALE CORP
CSGP	COSTAR GROUP INC
CTRX	COTHERIX INC
CFC	COUNTRYWIDE FINANCIAL
CRRC	COURIER CORP
CUZ	COUSINS PROPERTIES INC
CVD	COVANCE INC
CVNS	COVANSYS CORP
CVTI	COVENANT TRANS INC
CVH	COVENTRY HEALTH CARE
CXR	COX RADIO INC
CR	CRANE CO
CRD.B	CRAWFORD & CO
CMOS	CREDENCE SYSTEMS CORP
CACCE	CREDIT ACCEPTANCE CORP
CREE	CREE INC
CEI	CRESCENT REAL ESTATE
CMM	CRIIMI MAE INC
CK	CROMPTON CORP
CCRN	CROSS COUNTRY HEALTHCARE
XTXI	CROSSTEX ENERGY INC
CCI	CROWN CASTLE INTL CORP
CCK	CROWN HOLDINGS INC
CRWN	CROWN MEDIA HOLDINGS INC
CRO	CRT PROPERTIES INC
CUB	CUBIC CORP
CBST	CUBIST PHARMACEUTICALS
CFR	CULLEN FROST BANKERS
CMI	CUMMINS INC
CMLS	CUMULUS MEDIA INC
CRIS	CURIS INC
CRGN	CURAGEN CORP
CW	CURTISS WRIGHT CORP
CGFW	CYBERGUARD CORP
CYBS	CYBERSOURCE CORP
CYBX	CYBERONICS INC
CYMI	CYMER INC
CYPB	CYPRESS BIOSCIENCES INC
CY	CYPRESS SEMICONDUCTOR
CYT	CYTEC INDUSTRIES INC
CYTC	CYTYC CORP
DHB	DHB INDUSTRIES INC
DJO	DJ ORTHOPEDICS INC
DPL	DPL INC
DRS	DRS TECHNOLOGIES INC
DHI	D R HORTON INC
DST	DST SYSTEMS INC
DSPG	DSP GROUP INC
DTE	DTE ENERGY CO
DTSI	DTS INC
DADE	DADE BEHRING HLDGS INC
DAKT	DAKTRONICS INC
DCN	DANA CORP
DHR	DANAHER CORP
DHC	DANIELSON HOLDING CORP
DRI	DARDEN RESTAURANTS INC
DAR	DARLING INTERNATIONAL
DSCP	DATASCOPE CORP
DAB	DAVE & BUSTERS INC
DVA	DAVITA INC
DF	DEAN FOODS COMPANY
DEBS	DEB SHOPS INC
DECK	DECKERS OUTDOOR CORP
DCGN	DECODE GENETICS INC
DE	DEERE & CO
DLM	DEL MONTE FOODS CO
DELL	DELL INC
DPH	DELPHI CORP
DFG	DELPHI FINANCIAL GRP INC
DLP	DELTA & PINE LAND CO
DAL	DELTA AIR LINES INC
DEL	DELTIC TIMBER CORP
DPTR	DELTA PETROLEUM CORP
DNR	DENBURY RESOURCES INC
DFC	DELTA FINANCIAL CORP
DLX	DELUXE CORP
DRTE	DENDRITE INTERNATIONAL
DNDN	DENDREON CORP
DENN	DENNYS CORP
XRAY	DENTSPLY INTERNATIONAL
DWRI	DESIGN WITHIN REACH INC
DDR	DEVELOPERS DIVERSIFIED
DVN	DEVON ENERGY CORP
DV	DEVRY INC
DEX	DEX MEDIA INC
DXCM	DEXCOM INCDP DIAGNOSTIC PRODUCTS CORP
DO	DIAMOND OFFSHR DRILLING
DRH	DIAMONDROCK HOSPITALITY
DTPI	DIAMONDCLUSTER INTL INC
DKS	DICKS SPORTING GOODS INC
DBD	DIEBOLD INC
DIGE	DIGENE CORP
DGII	DIGI INTL INC
DGIN	DIGITAL INSIGHT CORP
DLR	DIGITAL REALTY TRUST INC
DRIV	DIGITAL RIVER INC
DTAS	DIGITAS INC
DCOM	DIME CMNTY BANCSHARES
DDS	DILLARDS INC
DIOD	DIODES INC
DNEX	DIONEX CORP
DRCT	DIRECT GENERAL CORP
DTV	DIRECTV GROUP INC
DSCO	DISCOVERY LABORATORIES
DIS	DISNEY WALT CO
DITC	DITECH COMMUNICATIONS
DVSA	DIVERSA CORP
DXYN	DIXIE GROUP INC
DCEL	DOBSON COMMUNICATIONS CO
DLB	DOLBY LABORATORIES INC
DG	DOLLAR GENERAL CORP
DTG	DOLLAR THRIFTY AUTO
DLTR	DOLLAR TREE STORES INC
D	DOMINION RESOURCES INC
DPZ	DOMINOS PIZZA INC
DCI	DONALDSON INC
DGICA	DONEGAL GROUP INC
RRD	DONNELLEY R R & SONS CO
DRL	DORAL FINANCIAL CORP
HILL	DOT HILL SYSTEMS CORP
DCLK	DOUBLECLICK INC
DOVP	DOV PHARMACEUTICAL INC
DOV	DOVER CORP
DDE	DOVER DOWNS GAMING & ENT
DVD	DOVER MOTORSPORTS INC
DOW	DOW CHEMICAL CO
DJ	DOW JONES & CO INC
DSL	DOWNEY FINANCIAL CORP
DWA	DREAMWORKS ANIMATION SKG
DBRN	DRESS BARN INC
DW	DREW INDUSTRIES INC
DRQ	DRIL-QUIP INC
DSCM	DRUGSTORE COM INC
DD	DU PONT E I DE NEMOURS
DUK	DUKE ENERGY CORP
DRE	DUKE REALTY CORP
DNB	DUN & BRADSTREET CORP
DQE	DUQUESNE LIGHT HOLDINGS
DRTK	DURATEK INC
DRRX	DURECT CORP
DUSA	DUSA PHARMACEUTICALS INC
DY	DYCOM INDUSTRIES INC
DDMX	DYNAMEX INC
BOOM	DYNAMIC MATERIALS CORP
DYN	DYNEGY INC
ECR	ECC CAPITAL CORP
EAGL	EGL INC
EELN	E-LOAN INC
EMC	E M C CORP
EMCI	EMC INS GROUP INC
ESV	ENSCO INTERNATIONAL INC
EOG	EOG RESOURCES INC
EPIX	EPIX PHARMACEUTICALS INC
EPNY	E PIPHANY INC
EPIQ	EPIQ SYSTEMS INC
ET	E TRADE FINANCIAL CORP
EXP	EAGLE MATERIALS INC
ELNK	EARTHLINK INC
EWBC	EAST WEST BANCORP INC
EGP	EASTGROUP PROPERTIES INC
EMN	EASTMAN CHEMICAL CO
EK	EASTMAN KODAK CO
ETN	EATON CORP
EV	EATON VANCE CORP
EBAY	EBAY INC
ELON	ECHELON CORP
DISH	ECHOSTAR COMMUNICATIONS
ECLP	ECLIPSYS CORP
ECL	ECOLAB INC
ECLG	ECOLLEGE COM
EPEX	EDGE PETROLEUM CORP
EIX	EDISON INTERNATIONAL
EDO	EDO CORP
EEEE	EDUCATE INC
EDMC	EDUCATION MGMT CORP
EDR	EDUCATION REALTY TRUST
AGE	EDWARDS AG INC
EW	EDWARDS LIFESCIENCES
EFD	EFUNDS CORP
EP	EL PASO CORP
EE	EL PASO ELECTRIC CO
ELRC	ELECTRO RENT CORP
ESIO	ELECTRO SCIENTIFIC INDS
ERTS	ELECTRONIC ARTS INC
EDS	ELECTRONIC DATA SYSTEMS
ELBO	ELECTRONICS BOUTIQUE
EFII	ELECTRONICS FOR IMAGING
RDEN	ELIZABETH ARDEN INC
ELK	ELKCORP
PERY	ELLIS PERRY INTL INC
EMAG	EMAGEON INC
EMKR	EMCORE CORP
EME	EMCOR GROUP INC
EMR	EMERSON ELECTRIC CO
EMMS	EMMIS COMMUNICATIONS
EDE	EMPIRE DISTRICT ELECTRIC
ELX	EMULEX CORP
ECPG	ENCORE CAPITAL GROUP INC
EAC	ENCORE ACQUISITION CO
WIRE	ENCORE WIRE CORP
ENMC	ENCORE MEDICAL CORP
ENCY	ENCYSIVE PHARMACEUTICALS
END	ENDEAVOUR INTERNATIONAL
ENWV	ENDWAVE CORP
ENDP	ENDO PHARMACEUTICALSENER ENERGY CONVERSION DEVICE
EGN	ENERGEN CORP
EAS	ENERGY EAST CORP
ENR	ENERGIZER HOLDINGS INC
EPL	ENERGY PARTNERS LTD
ENS	ENERSYS INC
EC	ENGELHARD CORP
EASI	ENGINEERED SUPPORT SYS
ENSI	ENERGYSOUTH INC
EBF	ENNIS INC
NPO	ENPRO INDUSTRIES INC
ESGR	ENSTAR GROUP INC
ENTG	ENTEGRIS INC
ETM	ENTERCOM COMMUNICATIONS
ETR	ENTERGY CORP
EFSC	ENTERPRISE FINL SERVICES
EPR	ENTERTAINMENT PPTYS TR
EVC	ENTRAVISION COMM CORP
ENTU	ENTRUST INC
ENZN	ENZON PHARMACEUTICALS
ENZ	ENZO BIOCHEM INC
ELAB	EON LABS INC
EPIC	EPICOR SOFTWARE CORP
EFX	EQUIFAX INC
EQIX	EQUINIX INC
EQT	EQUITABLE RESOURCES INC
ENN	EQUITY INNS INC
ELS	EQUITY LIFESTYLE PROP
EOP	EQUITY OFFICE PPTYS TR
EQY	EQUITY ONE INC
EQR	EQUITY RESIDENTIAL
ERES	ERESEARCHTECHNOLOGY INC
ERIE	ERIE INDEMNITY CO
ESCA	ESCALADE INC
ESE	ESCO TECHNOLOGIES INC
ESPD	ESPEED INC
KEYW	ESSEX CORP
ESS	ESSEX PROPERTY TRUST INC
ESL	ESTERLINE TECHNOLOGIES
ETH	ETHAN ALLEN INTERIORS
EUBK	EUROBANCSHARES INC
EEFT	EURONET WORLDWIDE INC
ESLR	EVERGREEN SOLAR INC
EXAR	EXAR CORP
XLTC	EXCEL TECHNOLOGY INC
EXC	EXELON CORP
EXEL	EXELIXIS INC
EXPD	EXPEDITORS INTL OF WASH
EXPO	EXPONENT INC
ESRX	EXPRESS SCRIPTS INC
XJT	EXPRESSJET HOLDINGS INC
EXR	EXTRA SPACE STORAGE INC
EXTR	EXTREME NETWORKS INC
EYET	EYETECH PHARMACEUTICALS
XOM	EXXON MOBIL CORP
FFG	FBL FINANCIAL GROUP INC
FEIC	FEI CO
FLIR	FLIR SYSTEMS INC
FMC	FMC CORP
FTI	FMC TECHNOLOGIES INC
FNB	FNB CORP
FPIC	FPIC INSURANCE GROUP INC
FPL	FPL GROUP INC
FTD	FTD GROUP INC
FXEN	FX ENERGY INC
FNBP	F N B CORP
FCN	FTI CONSULTING INC
FDS	FACTSET RESEARCH SYSTEMS
FIC	FAIR ISAAC CORP
FCS	FAIRCHILD SEMICONDUCTOR
FRP	FAIRPOINT COMMUNICATIONS
FALC	FALCONSTOR SOFTWARE
FDO	FAMILY DOLLAR STORES
FRGO	FARGO ELECTRONICS INC
FARM	FARMER BROS CO
FFKT	FARMERS CAPITAL BK CORP
FARO	FARO TECHNOLOGIES INC
FAST	FASTENAL CO
AGM	FEDERAL AGRIC MTG CO
FRE	FEDERAL HOME LN MTG
FNM	FEDERAL NATL MTG ASSOC
FRT	FEDERAL REALTY INVT
FSS	FEDERAL SIGNAL CORP
FD	FEDERATED DEPT STORE
FII	FEDERATED INVESTORS INC
FDX	FEDEX CORP
FCH	FELCOR LODGING TRUST INC
FOE	FERRO CORP
FFIV	F5 NETWORKS INC
FFFL	FIDELITY BANKSHARES INC
FNF	FIDELITY NATIONAL FINL
FICC	FIELDSTONE INVESTMENT CO
FITB	FIFTH THIRD BANCORP
FILE	FILENET CORP
FIF	FINANCIAL FED CORP
FISI	FINANCIAL INSTNS INC
FNSR	FINISAR CORP
FINL	FINISH LINE INC
FAC	FIRST ACCEPTANCE CORP
FADV	FIRST ADVANTAGE CORP
FAF	FIRST AMERICAN CORP
FBP	FIRST BANCORP PR
FBNC	FIRST BANCORP NC
BUSE	FIRST BUSEY CORP
FCFS	FIRST CASH FINANCIAL
FCTR	FIRST CHARTER CORP
FCNCA	FIRST CITIZENS BANCSHRS
FCF	FIRST COMMONWLTH FINL
FCBC	FIRST CMNTY BANCSHAR
FCBP	FIRST COMMUNITY BANCORP
FDC	FIRST DATA CORP
FDEF	FIRST DEFIANCE FINANCIAL
FFBC	FIRST FINANCIAL BANCORP
FFIN	FIRST FINL BANKSHARES
THFF	FIRST FINANCIAL CORP
FFCH	FIRST FINANCIAL HOLDINGS
FHN	FIRST HORIZON NATL CORP
FHRX	FIRST HORIZON PHARMA
FR	FIRST INDUSTRIAL RLTY TR
FINB	FIRST INDIANA CORPFMD FIRST MARBLEHEAD CORP
FRME	FIRST MERCHANTS CORP
FMBI	FIRST MIDWEST BANCORP
FNFG	FIRST NIAGARA FINL GRP
FOBB	FIRST OAK BROOK BANCSHRS
FPO	FIRST POTOMAC REALTY TR
FPFC	FIRST PLACE FINANCIAL
FRC	FIRST REPUBLIC BANK
FRGB	FIRST REGIONAL BANCORP
FSNM	FIRST STATE BANCORP
FSBK	FIRST SOUTH BANCORP INC
SRCE	1ST SOURCE CORP
FISV	FISERV INC
FSCI	FISHER COMMUNICATIONS
FED	FIRSTFED FINANCIAL CORP
FMER	FIRSTMERIT CORP
FBC	FLAGSTAR BANCORP INC
FE	FIRSTENERGY CORP
FSH	FISHER SCIENTIFIC INTL
FLDR	FLANDERS CORP
FLE	FLEETWOOD ENTERPRISES
FLA	FLORIDA EAST COAST INDS
FRK	FLORIDA ROCK INDUSTRIES
FLR	FLUOR CORP
FLO	FLOWERS FOODS INC
FLS	FLOWSERVE CORP
FFIC	FLUSHING FINANCIAL CORP
FL	FOOT LOCKER INC
F	FORD MOTOR CO
FCE.A	FOREST CITY ENTRPRS
FRX	FOREST LABS INC
FST	FOREST OIL CORP
FORM	FORMFACTOR INC
FORR	FORRESTER RESEARCH INC
FO	FORTUNE BRANDS INC
FWRD	FORWARD AIR CORP
FOSL	FOSSIL INC
FCL	FOUNDATION COAL HOLDINGS
FDRY	FOUNDRY NETWORKS INC
KDE	4 KIDS ENTERTAINMENT INC
FOXH	FOXHOLLOW TECHNOLOGIES
FBTX	FRANKLIN BANK CORP
FELE	FRANKLIN ELECTRIC CO
BEN	FRANKLIN RESOURCES INC
FRED	FREDS INC
FCX	FREEPORT-MCMORAN C&G
FSL.B	FREESCALE SEMICONDUCTOR
RAIL	FREIGHTCAR AMERICA INC
FMT	FREMONT GENERAL CORP
FBR	FRIEDMAN BILLINGS RAMSEY
FRNT	FRONTIER AIRLINES INC
FTBK	FRONTIER FINANCIAL CORP
FTO	FRONTIER OIL CORP
FFEX	FROZEN FOOD EXPRESS
FCEL	FUELCELL ENERGY INC
FUL	FULLER H B CO
FULT	FULTON FINANCIAL CORP
FBN	FURNITURE BRANDS INTL
GKSRA	G&K SERVICES INC
GMT	GATX CORP
GBTB	G B & T BANCSHARES INC
GGI	GEO GROUP INC
GFIG	GFI GROUP INC
GCT	GMH COMMUNITIES TRUST
GSIC	GSI COMMERCE INC
GBL	GABELLI ASSET MGMT INC
GBP	GABLES RESIDENTIAL TRUST
AJG	GALLAGHER ARTHUR J & CO
GME.B	GAMESTOP CORP
GCI	GANNETT INC
GPS	GAP INC
GDI	GARDNER DENVER INC
IT	GARTNER INC
GSX	GASCO ENERGY INC
GTW	GATEWAY INC
GET	GAYLORD ENTMT CO
GEHL	GEHL CO
GPRO	GEN-PROBE INC
GMST	GEMSTAR-TV GUIDE INTL
GY	GENCORP INC
DNA	GENENTECH INC
GBND	GENERAL BINDING CORP
BGC	GENERAL CABLE CORP
GNCMA	GENERAL COMMUNICATION
GD	GENERAL DYNAMICS CORP
GE	GENERAL ELECTRIC CO
GGP	GENERAL GROWTH PPTYS INC
GIS	GENERAL MILLS INC
GM	GENERAL MOTORS CORP
GCO	GENESCO INC
GWR	GENESEE & WYOMING INC
GNSS	GENESIS MICROCHIP INC
GHCI	GENESIS HEALTHCARE CORP
GNTX	GENTEX CORP
GTOP	GENITOPE CORP
GLYT	GENLYTE GROUP INC
GPC	GENUINE PARTS CO
GTIV	GENTIVA HEALTH SERVICES
GNW	GENWORTH FINANCIAL INC
GENZ	GENZYME CORP
GGC	GEORGIA GULF CORP
GP	GEORGIA PACIFIC CORP
GERN	GERON CORP
GYI	GETTY IMAGES INC
GTY	GETTY REALTY CORP
GVHR	GEVITY HR INC
GI	GIANT INDUSTRIES INC
ROCK	GIBRALTAR INDUSTRIES INC
GILD	GILEAD SCIENCES INC
G	GILLETTE CO
GBCI	GLACIER BANCORP INC
GLAD	GLADSTONE CAPITAL CORP
GLT	GLATFELTER
GEMS	GLENAYRE TECHNOLOGIES
GLB	GLENBOROUGH REALTY TRUST
GRT	GLIMCHER REALTY TRUST
GLBL	GLOBAL INDUSTRIES LTD
GISX	GLOBAL IMAGING SYSTEMS
GPN	GLOBAL PAYMENTS INC
GEG	GLOBAL POWER EQUIPMENTGSL GLOBAL SIGNAL INC
GTE	GLOBETEL COMMUNICATIONS
GLDB	GOLD BANC CORP INC
GKIS	GOLD KIST INC
GLDN	GOLDEN TELECOM INC
GDW	GOLDEN WEST FINANCIAL
GS	GOLDMAN SACHS GROUP INC
GR	GOODRICH CORP
GDP	GOODRICH PETROLEUM CORP
GT	GOODYEAR TIRE & RUBBER
GDYS	GOODYS FAMILY CLOTHING
GOOG	GOOGLE INC
GRC	GORMAN RUPP CO
GPP	GOVERNMENT PPTYS TRUST
GRA	GRACE W R & CO
GGG	GRACO INC
GTI	GRAFTECH INTL LTD
GWW	GRAINGER W W INC
GKK	GRAMERCY CAPITAL CORP
GVA	GRANITE CONSTR INC
GRP	GRANT PRIDECO INC
GPK	GRAPHIC PACKAGING CORP
GTN	GRAY TELEVISION INC
GFR	GREAT AMERICAN FINL RES
GAP	GREAT ATLANTIC & PAC TEA
GLK	GREAT LAKES CHEM CORP
GSBC	GREAT SOUTHERN BANCORP
GXP	GREAT PLAINS ENERGY INC
WOLF	GREAT WOLF RESORTS INC
GBBK	GREATER BAY BANCORP
GMCR	GREEN MTN COFFEE ROASTER
GBX	GREENBRIER COMPANIES INC
GCBS	GREENE COUNTY BANCSHARES
SRVY	GREENFIELD ONLINE
GHL	GREENHILL & CO INC
GEF	GREIF INC
GW	GREY WOLF INC
GFF	GRIFFON CORP
GPI	GROUP 1 AUTOMOTIVE INC
GTK	GTECH HOLDINGS CORP
GTXI	GTX INC
GES	GUESS INC
GDT	GUIDANT CORP
GTRC	GUITAR CENTER INC
GIFI	GULF ISLAND FABRICATION
GMRK	GULFMARK OFFSHORE INC
GYMB	GYMBOREE CORP
HCA	HCA INC
HCC	HCC INSURANCE HLDGS INC
HNI	HNI CORPORATION
HRP	HRPT PROPERTIES TRUST
HAE	HAEMONETICS CORP
HAIN	HAIN CELESTIAL GROUP
HAL	HALLIBURTON CO
HBHC	HANCOCK HOLDING CO
HDL	HANDLEMAN CO
HAFC	HANMI FINANCIAL CORP
HC	HANOVER COMPRESSOR CO
HANS	HANSEN NAT CORP
HARB	HARBOR FLORIDA BANCSHRS
JH	HARLAND JOHN H CO
HDI	HARLEY DAVIDSON INC
HGIC	HARLEYSVILLE GROUP INC
HNBC	HARLEYSVILLE NATIONAL
HAR	HARMAN INTERNATIONAL IND
HLIT	HARMONIC INC
HET	HARRAHS ENTMT INC
TINY	HARRIS & HARRIS GROUP
HRS	HARRIS CORP
HPOL	HARRIS INTERACTIVE INC
HSC	HARSCO CORP
HHS	HARTE HANKS INC
HIG	HARTFORD FINL SVCS GRP
HMX	HARTMARX CORP
HNR	HARVEST NATURAL RES
HAS	HASBRO INC
HVT	HAVERTY FURNITURE INC
HE	HAWAIIAN ELECTRIC INDS
HAYZ	HAYES LEMMERZ INTL INC
HCSG	HEALTHCARE SVCS GRP INC
HCP	HEALTH CARE PROPERTY INV
HMA	HEALTH MGMT ASSOC INC
HR	HEALTHCARE REALTY TRUST
HW	HEADWATERS INC
HCN	HEALTH CARE REIT INC
HLEX	HEALTHEXTRAS INC
HNT	HEALTH NET INC
HTRN	HEALTHTRONICS INC
HTV	HEARST-ARGYLE TELEVISION
HTLD	HEARTLAND EXPRESS INC
HTLF	HEARTLAND FINANCIAL USA
HL	HECLA MINING CO
HEI	HEICO CORP
HSII	HEIDRICK & STRUGGLES
HNZ	HEINZ H J CO
HELX	HELIX TECHNOLOGY CORP
HP	HELMERICH & PAYNE INC
JKHY	HENRY JACK & ASSOCIATES
HTBK	HERITAGE COMMERCE CORP
HPC	HERCULES INC
HTG	HERITAGE PROPERTY INV TR
HRLY	HERLEY INDUSTRIES INC
HT	HERSHA HOSPITALITY TRUST
HSY	HERSHEY COMPANY
HEW	HEWITT ASSOCIATES INC
HPQ	HEWLETT PACKARD CO
HXL	HEXCEL CORP
HITK	HI-TECH PHARMACAL CO INC
HIBB	HIBBETT SPORTING GOODS
HIB	HIBERNIA CORP
HIH	HIGHLAND HOSPITALITY
HIW	HIGHWOODS PROPERTIES INC
HRH	HILB ROGAL & HOBBS CO
HB	HILLENBRAND INDUSTRIES
HLT	HILTON HOTELS CORP
HLR	HOLLINGER INTERNATIONAL
HOC	HOLLY CORP
HOLX	HOLOGIC INC
HD	HOME DEPOT INC
HME	HOME PROPERTIES INCHMB HOMEBANC CORP
HOMS	HOMESTORE INC
HON	HONEYWELL INTERNATIONAL
HOFT	HOOKER FURNITURE CORP
HH	HOOPER HOLMES INC
HMN	HORACE MANN EDUCATORS
HRZB	HORIZON FINANCIAL CORP
HORC	HORIZON HEALTH CORP
HRL	HORMEL FOODS CORP
HOS	HORNBECK OFFSHORE SVCS
HSP	HOSPIRA INC
HPT	HOSPITALITY PPTYS TRUST
HMT	HOST MARRIOTT CORP
HOTT	HOT TOPIC INC
SOLD	HOUSEVALUES INC
THX	HOUSTON EXPLORATION CO
HOV	HOVNANIAN ENTERPRISES
HUBG	HUB GROUP INC
HUB.B	HUBBELL INC
HCBK	HUDSON CITY BANCORP
HHGP	HUDSON HIGHLAND GROUP
HU	HUDSON UNITED BANCORP
HUG	HUGHES SUPPLY INC
HUM	HUMANA INC
HGSI	HUMAN GENOME SCIENCES
HTC	HUNGARIAN TEL & CABLE CO
JBHT	HUNT J B TRANS SVCS
HBAN	HUNTINGTON BANCSHARES
HUN	HUNTSMAN CORP
HURN	HURON CONSULTING GROUP
HTCH	HUTCHINSON TECHNOLOGY
HBP	HUTTIG BUILDING PRODUCTS
HYDL	HYDRIL
IDT	IDT CORP
HYC	HYPERCOM CORP
HYSL	HYPERION SOLUTIONS CORP
IACI	IAC INTERACTIVECORP
ICOS	ICOS CORP
ICUI	ICU MEDICAL INC
IDXC	IDX SYSTEMS CORP
IFLO	I-FLOW CORP
IHP	IHOP CORP
RX	IMS HEALTH INC
SFI	ISTAR FINANCIAL INC
ISTA	ISTA PHARMACEUTICALS INC
ITLA	ITLA CAPITAL CORP
ESI	ITT EDUCATIONAL SVCS INC
XXIA	IXIA
IBKC	IBERIABANK CORP
ITT	ITT INDUSTRIES INC
IDA	IDACORP INC
IDIX	IDENIX PHARMACEUTICALS
IEX	IDEX CORP
IDXX	IDEXX LABS INC
IGTE	IGATE CORP
IKN	IKON OFFICE SOLUTIONS
IDNX	IDENTIX INC
ITW	ILLINOIS TOOL WORKS INC
ILMN	ILLUMINA INC
IMN	IMATION CORP
IMCL	IMCLONE SYSTEMS INC
IGI	IMAGISTICS INTERNATIONAL
BLUD	IMMUCOR INC
IMGN	IMMUNOGEN INC
IMH	IMPAC MORTGAGE HOLDINGS
IPXLE	IMPAX LABORATORIES INC
IMDC	INAMED CORP
INCY	INCYTE CORP
ICBC	INDEPENDENCE CMNTY BANK
IHC	INDEPENDENCE HOLDING CO
INDB	INDEPENDENT BANK MA
IBCP	INDEPENDENT BANK MI
NDE	INDYMAC BANCORP INC
IFOX	INFOCROSSING INC
IPCC	INFINITY PPTY & CAS CORP
INFA	INFORMATICA CORP
INSP	INFOSPACE INC
IUSA	INFOUSA INC
IFS	INFRASOURCE SVCS INC
IMKTA	INGLES MARKETS INC
IM	INGRAM MICRO INC
IRC	INLAND REAL ESTATE CORP
IO	INPUT/OUTPUT INC
NSIT	INSIGHT ENTERPRISES INC
INSU	INSITUFORM TECHNOLOGIES
ICCI	INSIGHT COMMUNICATIONS
ISSC	INNOVATIVE SOLUTIONS
KPA	INNKEEPERS USA TRUST
INPC	INPHONIC INC
ISPH	INSPIRE PHARMACEUTICALS
INGP	INSTINET GROUP INC
INNO	INNOVO GROUP INC
IART	INTEGRA LIFESCIENCES
ISYS	INTEGRAL SYSTEMS INC
IDTI	INTEGRATED DEVICE TECH
ICST	INTEGRATED CIRCUIT SYS
ISSI	INTEGRATED SILICON S
INTC	INTEL CORP
IBNK	INTEGRA BANK CORP
IPAR	INTER PARFUMS INC
INTL	INTER TEL INC
IDC	INTERACTIVE DATA CORP
IFCJ	INTERCHANGE FINL SVCS
IFSIA	INTERFACE INC
IDCC	INTERDIGITAL COMM CORP
INGR	INTERGRAPH CORP
IBI	INTERLINE BRANDS INC
IMGC	INTERMAGNETICS GENERAL
MIX	INTERMIX MEDIA INC
ITMN	INTERMUNE INC
IBOC	INTERNATIONAL BANCSHARES
IBM	INTL BUSINESS MACHINES
IDWK	INTL DISPLAYWORKS INC
IFF	INTL FLAVORS & FRAGRANCE
IGT	INTL GAME TECHNOLOGY
IP	INTERNATIONAL PAPER CO
IRF	INTERNATIONAL RECTIFIER
ISE	INTL SECURITIES EXCHANGE
ISCA	INTERNATIONAL SPEEDWAY
ICGE	INTERNET CAPITAL GROUPISSX INTERNET SECURITY SYS
IPX	INTERPOOL INC
IPG	INTERPUBLIC GROUP OF COS
ISIL	INTERSIL CORP
INTV	INTERVOICE INC
IVAC	INTEVAC INC
IWOV	INTERWOVEN INC
IVII	INTERVIDEO INC
ILSE	INTRALASE CORP
TRDO	INTRADO INC
INGN	INTROGEN THERAPEUTICS
INTU	INTUIT
IVC	INVACARE CORP
ISRG	INTUITIVE SURGICAL INC
IMA	INVERNESS MED INNOVATION
ITG	INVESTMENT TECHNOLOGY
IRETS	INVESTORS REAL ESTATE TR
IVGN	INVITROGEN CORP
IFIN	INVESTORS FINANCIAL SVCS
IOTN	IONATRON INC
IWA	IOWA TELECOMM SERVICES
IPAS	IPASS INC
IPMT	IPAYMENT INC
IRIS	IRIS INTERNATIONAL INC
IRM	IRON MOUNTAIN INC
IFC	IRWIN FINANCIAL CORP
ISIS	ISIS PHARMACEUTICALS
ISLE	ISLE OF CAPRI CASINOS
ITRI	ITRON INC
IVX	IVAX CORP
IVIL	IVILLAGE INC
SYXI	IXYS CORP
JJSF	J & J SNACK FOODS CO
JDSU	JDS UNIPHASE CORP
JDAS	JDA SOFTWARE GROUP INC
JILL	J JILL GROUP INC
JLG	JLG INDUSTRIES INC
JPM	JPMORGAN CHASE & CO
JCOM	J2 GLOBAL COMMUNICATIONS
JBL	JABIL CIRCUIT INC
JBX	JACK IN THE BOX INC
JTX	JACKSON HEWITT TAX SVC
JEC	JACOBS ENGINEERING GRP
JJZ	JACUZZI BRANDS INC
JAKK	JAKKS PACIFIC INC
JMDT	JAMDAT MOBILE INC
JRCC	JAMES RIVER COAL CO
JNS	JANUS CAPITAL GROUP INC
JAH	JARDEN CORP
JEF	JEFFERIES GROUP INC
JP	JEFFERSON PILOT CORP
JBLU	JETBLUE AIRWAYS CORP
JAS	JO-ANN STORES INC
JNJ	JOHNSON & JOHNSON
JCI	JOHNSON CONTROLS INC
JNY	JONES APPAREL GROUP INC
JLL	JONES LANG LASALLE INC
JOR	JORGENSEN EARLE M CO
JOSB	JOS A BANK CLOTHIERS INC
JRN	JOURNAL COMMUNICATIONS
JRC	JOURNAL REGISTER CO
JOYG	JOY GLOBAL INC
JNPR	JUNIPER NETWORKS INC
JUPM	JUPITERMEDIA CORP
KCS	KCS ENERGY INC
KFX	KFX INC
KLAC	KLA-TENCOR CORP
KMA	KMG AMERICA CORP
KSWS	K-SWISS INC
KTO	K2 INC
KV.A	K V PHARMACEUTICAL CO
KAI	KADANT INC
KNBT	KNBT BANCORP INC
KAMNA	KAMAN CORP
KBAY	KANBAY INTERNATIONAL INC
KCLI	KANSAS CITY LIFE INS CO
KSU	KANSAS CITY SOUTHERN
KDN	KAYDON CORP
KEA	KEANE INC
KBH	KB HOME
KRNY	KEARNY FINANCIAL CORP
KEI	KEITHLEY INSTRS INC
K	KELLOGG CO
KWD	KELLWOOD CO
KELYA	KELLY SERVICES INC
KEM	KEMET CORP
KMT	KENNAMETAL INC
KNSY	KENSEY NASH CORP
KMG	KERR MCGEE CORP
KERX	KERYX BIOPHARMACEUTICALS
KEY	KEYCORP
KEYN	KEYNOTE SYSTEMS INC
KSE	KEYSPAN CORP
KEYS	KEYSTONE AUTOMOTIVE INDS
KFRC	KFORCE INC
KBALB	KIMBALL INTERNATIONAL
KRC	KILROY REALTY CORP
KMB	KIMBERLY CLARK CORP
KIM	KIMCO REALTY CORP
KMI	KINDER MORGAN INC
KND	KINDRED HEALTHCARE INC
KCI	KINETIC CONCEPTS INC
KG	KING PHARMACEUTICALS INC
KEX	KIRBY CORP
KRG	KITE REALTY GROUP TRUST
KNL	KNOLL INC
NITE	KNIGHT CAPITAL GROUP INC
KRI	KNIGHT RIDDER INC
KNX	KNIGHT TRANSPORTATION
KSS	KOHLS CORP
KOMG	KOMAG INC
KOPN	KOPIN CORP
KFY	KORN FERRY INTERNATIONAL
KOSP	KOS PHARMACEUTICALS INC
KFT	KRAFT FOODS INC
KKD	KRISPY KREME DOUGHNUTS
KR	KROGER CO
KRON	KRONOS INC
KRO	KRONOS WORLDWIDE INC
KLIC	KULICKE & SOFFA INDSKYPH KYPHON INC
LCAV	LCA-VISION INC
LKQX	LKQ CORP
LSI	LSI LOGIC CORP
LYTS	LSI INDUSTRIES INC
LTC	LTC PROPERTIES INC
LTXX	LTX CORP
LLL	L-3 COMMUNICATIONS HLDGS
LB	LABARGE INC
LQI	LA QUINTA CORPORATION
LZB	LA Z BOY INC
LRW	LABOR READY INC
LABS	LABONE INC
LH	LABORATORY CORP OF AMER
LAB	LABRANCHE & CO INC
LG	LACLEDE GROUP INC
LAF	LAFARGE NORTH AMERICA
LI	LAIDLAW INTERNATIONAL
LBAI	LAKELAND BANCORP INC
LKFN	LAKELAND FINANCIAL CORP
LACOE	LAKES ENTERTAINMENT INC
LRCX	LAM RESEARCH CORP
LAMR	LAMAR ADVERTISING CO
LANC	LANCASTER COLONY CORP
LNCE	LANCE INC
LDR	LANDAUER INC
LFG	LANDAMERICA FINL GROUP
LNY	LANDRYS RESTAURANTS INC
LSTR	LANDSTAR SYSTEMS INC
LVS	LAS VEGAS SANDS CORP
LHO	LASALLE HOTEL PROPERTIES
LSCP	LASERSCOPE
LSCC	LATTICE SEMICONDUCTOR
EL	ESTEE LAUDER COMPANIES
LAUR	LAUREATE EDUCATION INC
LAWS	LAWSON PRODUCTS INC
LWSN	LAWSON SOFTWARE INC
LAYN	LAYNE CHRISTENSEN CO
LDIS	LEADIS TECHNOLOGY INC
LEA	LEAR CORP
LF	LEAPFROG ENTERPRISES INC
LTRE	LEARNING TREE INTL INC
XPRT	LECG CORP
LCRY	LECROY CORP
LEE	LEE ENTERPRISES INC
LEG	LEGGETT & PLATT INC
LM	LEGG MASON INC
LEH	LEHMAN BROTHERS HOLDINGS
LEN	LENNAR CORP
LII	LENNOX INTERNATIONAL INC
LUK	LEUCADIA NATIONAL CORP
LVLT	LEVEL 3 COMMUNICATIONS
LEV	LEVITT CORP
LEXR	LEXAR MEDIA INC
LEXG	LEXICON GENETICS INC
LXP	LEXINGTON CORP PPTYS
LXK	LEXMARK INTERNATIONAL
LBY	LIBBEY INC
LC	LIBERTY CORP
LBTYA	LIBERTY GLOBAL INC
L	LIBERTY MEDIA CORP
LRY	LIBERTY PROPERTY TRUST
LCUT	LIFETIME HOAN CORP
LIFC	LIFECELL CORP
LTM	LIFE TIME FITNESS INC
LIFE	LIFELINE SYSTEMS INC
LPNT	LIFEPOINT HOSPITALS
LGNDE	LIGAND PHARMACEUTICAL
LLY	LILLY ELI & CO
LTD	LIMITED BRANDS INC
TVL	LIN TV CORP
LNCR	LINCARE HOLDINGS INC
LECO	LINCOLN ELECTRIC HLDGS
LNC	LINCOLN NATIONAL CORP
LNN	LINDSAY MANUFACTURING CO
LLTC	LINEAR TECHNOLOGY CO
LIN	LINENS N THINGS INC
LIOX	LIONBRIDGE TECHNOLOGIES
LAD	LITHIA MOTORS INC
LFUS	LITTELFUSE INC
LIZ	LIZ CLAIBORNE INC
LOJN	LO-JACK CORP
LMT	LOCKHEED MARTIN CORP
LNET	LODGENET ENTMT CORP
LGN	LODGIAN INC
LTR	LOEWS CORP
CG	LOEWS CORP - CAROLINA GR
STAR	LONE STAR STEAKHOUSE
LSS	LONE STAR TECHNOLOGIES
LDG	LONGS DRUG STORES CO
LFB	LONGVIEW FIBRE CO
LPX	LOUISIANA PACIFIC CORP
LOW	LOWES COS INC
LZ	LUBRIZOL CORP
LUB	LUBYS INC
LU	LUCENT TECHNOLOGIES
LUFK	LUFKIN INDUSTRIES INC
LUM	LUMINENT MORTGAGE CAP
LMNX	LUMINEX CORP
WLS	LYON WILLIAM HOMES
LYO	LYONDELL CHEMICAL CO
MFW	M & F WORLDWIDE CORP
MTB	M & T BANK CORP
MAFB	MAF BANCORP INC
MBI	MBIA INC
KRB	MBNA CORP
MBFI	MB FINANCIAL INC
MDC	MDC HOLDINGS INC
MDU	MDU RESOURCES GROUP INC
MCIP	MCI INC
WFR	MEMC ELECTRIC MATERIALS
MFA	MFA MORTGAGE INVESTMENTS
MGEE	MGE ENERGY INC
MTG	MGIC INVESTMENT CORP
MOGN	MGI PHARMA INC
MGM	MGM MIRAGE
MHO	M/I HOMES INC
MKSI	MKS INSTRUMENTS INC
MPS	MPS GROUP INC
MRVC	MRV COMMUNICATIONS INCMROI MRO SOFTWARE INC
MSM	MSC INDL DIRECT INC
MNTG	MTR GAMING GROUP INC
MTSC	MTS SYSTEMS CORP
MTCT	MTC TECHNOLOGIES INC
MCBC	MACATAWA BANK CORP
MRD	MACDERMID INC
MAC	MACERICH CO
CLI	MACK CALI REALTY CORP
MVSN	MACROVISION CORP
MACR	MACROMEDIA INC
SHOO	MADDEN STEVEN LTD
MGLN	MAGELLAN HEALTH SVCS INC
LAVA	MAGMA DESIGN AUTOMATION
MECA	MAGNA ENTERTAINMENT CORP
MPG	MAGUIRE PPTYS INC
MSBK	MAIN STREET BANKS INC
MSFG	MAINSOURCE FINANCIAL GRP
MAIR	MAIR HOLDINGS INC
COOL	MAJESCO ENTERTAINMENT CO
MANH	MANHATTAN ASSOCS INC
MTW	MANITOWOC CO INC
MTEX	MANNATECH INC
GMAI	GREG MANNING AUCTIONS
MNKD	MANNKIND CORP
HCR	MANOR CARE INC
MAN	MANPOWER INC
MANT	MANTECH INTERNATIONAL
MAPS	MAPINFO CORP
MRO	MARATHON OIL CORP
MCHX	MARCHEX INC
MCS	MARCUS CORP
HZO	MARINEMAX INC
MPX	MARINE PRODUCTS CORP
TUG	MARITRANS INC
MKL	MARKEL CORP
MKTX	MARKETAXESS HOLDINGS INC
MWP	MARKWEST HYDROCARBON INC
MRLN	MARLIN BUSINESS SVCS
MMC	MARSH & MCLENNAN COS
MI	MARSHALL & ILSLEY CORP
MAR	MARRIOTT INTL INC
MSHL	MARSHALL EDWARDS INC
MATK	MARTEK BIOSCIENCES CORP
MRTN	MARTEN TRANS LTD
MSO	MARTHA STEWART LIVING
MLM	MARTIN MARIETTA MTLS
MVL	MARVEL ENTERPRISES INC
MAS	MASCO CORP
MEE	MASSEY ENERGY CORP
MTZ	MASTEC INC
MATR	MATRIA HEALTHCARE INC
MONEE	MATRIXONE INC
MAT	MATTEL INC
MATW	MATTHEWS INTERNATIONAL
MTSN	MATTSON TECHNOLOGY INC
MLP	MAUI LAND & PINEAPPLE CO
MXO	MAXTOR CORP
MXIM	MAXIM INTEGRATED PRODS
MAXY	MAXYGEN INC
MAY	MAY DEPARTMENT STORES CO
MVK	MAVERICK TUBE CORP
MMS	MAXIMUS INC
MYG	MAYTAG CORP
MBTF	MBT FINANCIAL CORP
MFE	MCAFEE INC
MNI	MCCLATCHY CO
MKC	MCCORMICK & CO INC
MSSR	MCCORMICK & SCHMICKS
MCDTA	MCDATA CORP
MCD	MCDONALDS CORP
MCGC	MCG CAPITAL CORP
MGRC	MCGRATH RENTCORP
MHP	MCGRAW HILL COS INC
MCK	MCKESSON CORP
MMR	MCMORAN EXPLORATION CO
MWV	MEADWESTVACO CORP
MSS	MEASUREMENT SPECIALTIES
MEDX	MEDAREX INC
MDTH	MEDCATH CORP
MHS	MEDCO HEALTH SOLUTIONS
MEG	MEDIA GENERAL INC
MCCC	MEDIACOM COMM CORP
MDCO	MEDICINES CO
MRX	MEDICIS PHARMACEUTICAL
MEDI	MEDIMMUNE INC
MDTL	MEDIS TECHNOLOGIES LTD
MDT	MEDTRONIC INC
MEL	MELLON FINANCIAL CORP
MW	MENS WEARHOUSE INC
MNT	MENTOR CORP
MENT	MENTOR GRAPHICS CORP
MBWM	MERCANTILE BANK CORP
MRBK	MERCANTILE BANKSHARES
MERCS	MERCER INTERNATIONAL INC
MRK	MERCK & CO INC
MRCY	MERCURY COMPUTER SYSTEMS
MCY	MERCURY GENERAL CORP
MERQ	MERCURY INTERACTIVE CORP
MDP	MEREDITH CORP
VIVO	MERIDIAN BIOSCIENCE INC
TMR	MERIDIAN RESOURCE CORP
MHX	MERISTAR HOSPITALITY
MMSI	MERIT MED SYSTEMS INC
MRGE	MERGE TECHNOLOGIES INC
MTH	MERITAGE HOMES CORP
MER	MERRILL LYNCH & CO INC
MESA	MESA AIR GROUP INC
MCC	MESTEK INC
MTLM	METAL MGMT INC
MUSA	METALS USA INC
METH	METHODE ELECTRS INC
MET	METLIFE INC
MXT	METRIS COMPANIES INC
MTLG	METROLOGIC INSTRS INC
MTD	METTLER TOLEDO INTL INC
MIK	MICHAELS STORES INC
MCRL	MICREL INC
MCRS	MICROS SYSTEMS INC
MSFT	MICROSOFT CORPMSTR MICROSTRATEGY INC
MTIX	MICRO THERAPEUTICS INC
MCHP	MICROCHIP TECHNOLOGY
MUSE	MICROMUSE INC
MU	MICRON TECHNOLOGY INC
MSCC	MICROSEMI CORP
TUNE	MICROTUNE INC DEL
MAA	MID-AMER APT CMNTYS
MDST	MID-STATE BANCSHARES
MDS	MIDAS GROUP INC
MIDD	MIDDLEBY CORP
MSEX	MIDDLESEX WATER CO
MLAN	MIDLAND CO
MWY	MIDWAY GAMES INC
MBHI	MIDWEST BANC HOLDING
PGIC	MIKOHN GAMING CORP
MLNM	MILLENNIUM PHARM INC
MLHR	MILLER HERMAN INC
MIL	MILLIPORE CORP
MLS	MILLS CORP
MSA	MINE SAFETY APPLIANCES
MTX	MINERALS TECHNOLOGIES
MIPS	MIPS TECHNOLOGIES INC
MSSN	MISSION RESOURCES CORP
MINI	MOBILE MINI INC
MOBE	MOBILITY ELECTRONICS INC
MOD	MODINE MANUFACTURING CO
MHK	MOHAWK INDUSTRIES INC
MDCC	MOLECULAR DEVICES CORP
MOLX	MOLEX INC
MOH	MOLINA HEALTHCARE INC
TAP	MOLSON COORS BREWING CO
MNTA	MOMENTA PHARMACEUTICALS
MNC	MONACO COACH CORP
MCRI	MONARCH CASINO & RESORT
MGI	MONEYGRAM INTERNATIONAL
MPWR	MONOLITHIC POWER SYSTEMS
MNRO	MONRO MUFFLER BRAKE INC
MON	MONSANTO CO
MNST	MONSTER WORLDWIDE INC
MCO	MOODYS CORP
MOG.A	MOOG INC
MWD	MORGAN STANLEY
MORN	MORNINGSTAR INC
MHL	MORTGAGEIT HOLDINGS INC
MOS	MOSAIC COMPANY
MOTV	MOTIVE INC
MOT	MOTOROLA INC
MOV	MOVADO GROUP INC
MOVI	MOVIE GALLERY INC
MLI	MUELLER INDUSTRIES INC
MFLX	MULTI-FINELINE ELECTRON
MGAM	MULTIMEDIA GAMES INC
MUR	MURPHY OIL CORP
MYE	MYERS INDUSTRIES INC
MYK	MYKROLIS CORP
MYL	MYLAN LABORATORIES INC
MYGN	MYRIAD GENETICS INC
MYOG	MYOGEN INC
NBY	NBC CAPITAL CORP
NBTB	NBT BANCORP INC
NTY	NBTY INC
NCS	NCI BUILDING SYSTEMS INC
NCOG	NCO GROUP INC
NCR	NCR CORP
NSS	NS GROUP INC
NASB	NASB FINANCIAL INC
NGPC	NGP CAPITAL RESOURCES
NIHD	NII HOLDINGS INC
EGOV	NIC INC
NL	NL INDUSTRIES INC
NNBR	NN INC
NPSP	NPS PHARMACEUTICALS INC
NRG	NRG ENERGY INC
NTLI	NTL INC
NUCO	NUCO2 INC
NVR	NVR INC
NABI	NABI BIOPHARMACEUTICALS
NC	NACCO INDUSTRIES INC
NLC	NALCO HOLDING COMPANY
NGEN	NANOGEN INC
NARAE	NARA BANCORP INC
NDAQ	NASDAQ STOCK MARKET INC
NAFC	NASH FINCH CO
NSTK	NASTECH PHARMACEUTICAL
FIZ	NATIONAL BEVERAGE CORP
NCC	NATIONAL CITY CORP
NHR	NATIONAL HEALTH REALTY
NHC	NATIONAL HEALTHCARE CORP
NFP	NATIONAL FINL PARTNERS
NFG	NATIONAL FUEL GAS CO
NHI	NATIONAL HEALTH INVS INC
NATI	NATIONAL INSTRS CORP
NATL	NATIONAL INTERSTATE CORP
NOV	NATIONAL OILWELL VARCO
NPBC	NATIONAL PENN BANCSHARES
NPK	NATIONAL PRESTO INDS INC
NSM	NATIONAL SEMICONDUCTOR
NWLIA	NATIONAL WESTRN LIFE INS
NFS	NATIONWIDE FINL SVCS
NHP	NATIONWIDE HEALTH PPTYS
NAVG	NAVIGATORS GROUP INC
NATR	NATURES SUNSHINE PRODS
NLS	NAUTILUS INC
NAVR	NAVARRE CORP
NAV	NAVISTAR INTERNATIONAL
NCI	NAVIGANT CONSULTING INC
FLYRE	NAVIGANT INTERNATIONAL
NVT	NAVTEQ CORP
NDC	NDCHEALTH CORP
NP	NEENAH PAPER INC
NCRX	NEIGHBORCARE INC
NMG.A	NEIMAN MARCUS GROUP INC
NKTR	NEKTAR THERAPEUTICS
NNI	NELNET INC
TNM	NELSON THOMAS INC
NEOL	NEOPHARM INC
NTBK	NETBANK INC
NSTC	NESS TECHNOLOGIES INC
NFLX	NETFLIX INCNTGR NETGEAR INC
NTIQ	NETIQ CORP
NTCT	NETSCOUT SYSTEMS INC
NTRT	NETRATINGS INC
NETL	NETLOGIC MICROSYSTEMS
NTAP	NETWORK APPLIANCE INC
NRGN	NEUROGEN CORP
NURO	NEUROMETRIX INC
NBIX	NEUROCRINE BIOSCIENCES
NEW	NEW CENTURY FINANCIAL
NJR	NEW JERSEY RESOURCES
NXL	NEW PLAN EXCEL REALTY TR
NRPH	NEW RIVER PHARMA
NWY	NEW YORK & CO INC
NYB	NEW YORK CMNTY BANCORP
NYT	NEW YORK TIMES CO
NAL	NEWALLIANCE BANCSHARES
NCT	NEWCASTLE INVESTMENT
NWL	NEWELL RUBBERMAID INC
NFX	NEWFIELD EXPLORATION CO
NEU	NEWMARKET CORPORATION
NEM	NEWMONT MINING CORP
NR	NEWPARK RESOURCES INC
NEWP	NEWPORT CORP
NWS.A	NEWS CORP
NXTL	NEXTEL COMMUNICATIONS
NXTP	NEXTEL PARTNERS INC
GAS	NICOR INC
NKE	NIKE INC
NIKU	NIKU CORP
NDN	99 CENTS ONLY STORES
NI	NISOURCE INC
NTMD	NITROMED INC
NBL	NOBLE ENERGY INC
NOBL	NOBLE INTL LTD
NDSN	NORDSON CORP
JWN	NORDSTROM INC
NSC	NORFOLK SOUTHERN CORP
NFB	NORTH FORK BANCORP
NPSI	NORTH PITTSBURGH SYSTEMS
NU	NORTHEAST UTILITIES
NREB	NORTHERN EMPIRE BANCSHAR
NTRS	NORTHERN TRUST CORP
NFLD	NORTHFIELD LABS INC
NOC	NORTHROP GRUMMAN CORP
NRF	NORTHSTAR REALTY FINANCE
NWAC	NORTHWEST AIRLINES CORP
NWSB	NORTHWEST BANCORP INC
NWN	NORTHWEST NATURAL GAS CO
NWEC	NORTHWESTERN CORP
NVTL	NOVATEL WIRELESS INC
NFI	NOVASTAR FINANCIAL INC
NOVL	NOVELL INC
NVLS	NOVELLUS SYSTEMS INC
NOVN	NOVEN PHARMACEUTICALS
NUS	NU SKIN ENTERPRISES
NST	NSTAR
NUE	NUCOR CORP
NVDA	NVIDIA CORP
NTRI	NUTRI SYSTEM INC
NUVA	NUVASIVE INC
NUVO	NUVELO INC
CHUX	O CHARLEYS INC
OGE	OGE ENERGY CORP
OCA	OCA INC
OMG	OM GROUP INC
JNC	NUVEEN INVESTMENTS INC
OSIP	OSI PHARMACEUTICALS
OSIS	OSI SYSTEMS INC
OO	OAKLEY INC
OXY	OCCIDENTAL PETE CORP
RHEO	OCCULOGIX INC
OII	OCEANEERING INTL INC
OCFC	OCEANFIRST FINANCIAL
OTL	OCTEL CORP
OCN	OCWEN FINANCIAL CORP
OMR	ODYSSEY MARINE EXPLOR
ODSY	ODYSSEY HEALTHCARE INC
ORH	ODYSSEY RE HOLDINGS CORP
ODP	OFFICE DEPOT INC
OMX	OFFICEMAX INC
OLG	OFFSHORE LOGISTICS INC
OCAS	OHIO CASUALTY CORP
OIS	OIL STATES INTERNATIONAL
ODFL	OLD DOMINION FREIGHT
ONB	OLD NATIONAL BANCORP
ORI	OLD REPUBLIC INTL CORP
OSBC	OLD SECOND BANCORP INC
OLN	OLIN CORP
OCR	OMNICARE INC
OMC	OMNICOM GROUP INC
OHI	OMEGA HEALTHCARE INVS
CTAC	1-800 CONTACTS INC
OMEF	OMEGA FINANCIAL CORP
OVTI	OMNIVISION TECHNOLOGIES
ONNN	ON SEMICONDUCTOR CORP
OLP	ONE LIBERTY PROPERTIES
FLWS	1-800 FLOWERS COM
OKE	ONEOK INC
ORCC	ONLINE RESOURCES CORP
ONXX	ONYX PHARMACEUTICALS INC
OPWV	OPENWAVE SYSTEMS INC
OPEN	OPEN SOLUTIONS INC
OPLK	OPLINK COMMUNICATIONS
OCPI	OPTICAL COMMUNICATION
OPSW	OPSWARE INC
ORCL	ORACLE CORP
OPTN	OPTION CARE INC
OXPS	OPTIONSXPRESS HOLDINGS
OSUR	ORASURE TECHNOLOGIES INC
ORB	ORBITAL SCIENCES CORP
ORCH	ORCHID CELLMARK INC
OS	OREGON STEEL MILLS INC
ORLY	O REILLY AUTOMOTIVE INC
OFG	ORIENTAL FINANCIAL GROUP
ORGN	ORIGEN FINANCIAL INC
OHB	ORLEANS HOMEBUILDERS INC
ORA	ORMAT TECHNOLOGIES INC
GOSHA	OSHKOSH B GOSH INC
OSK	OSHKOSH TRUCK CORPOTTR OTTER TAIL CORP
OSI	OUTBACK STEAKHOUSE INC
OUTD	OUTDOOR CHANNEL HLDGS
OVNT	OVERNITE CORP
OSG	OVERSEAS SHIPHOLDNG GRP
OSTK	OVERSTOCK COM INC
OMI	OWENS & MINOR INC
OI	OWENS ILLINOIS INC
OXM	OXFORD INDUSTRIES INC
PTSI	P A M TRANSN SVCS INC
PDFS	PDF SOLUTIONS INC
PCG	PG&E CORP
PFB	PFF BANCORP INC
PHH	PHH CORPORATION
PFCB	P F CHANGS CHINA BISTRO
PICO	PICO HOLDINGS INC
PLXT	PLX TECHNOLOGY INC
PMACA	PMA CAPITAL CORP
PMCS	PMC-SIERRA INC
PMI	PMI GROUP INC
PNC	PNC FINANCIAL SVCS GROUP
PNM	PNM RESOURCES INC
PPG	PPG INDUSTRIES INC
PPL	PPL CORP
PRAI	PRA INTERNATIONAL
PRGX	PRG-SCHULTZ INTL INC
PSB	PS BUSINESS PARKS INC
PSSI	PSS WORLD MEDICAL INC
PCAR	PACCAR INC
PACR	PACER INTERNATIONAL INC
PCBC	PACIFIC CAPITAL BANCORP
PEIX	PACIFIC ETHANOL INC
PSUN	PACIFIC SUNWEAR OF CALIF
PHS	PACIFICARE HEALTH SYS
PKG	PACKAGING CORP OF AMER
PKTR	PACKETEER INC
PTV	PACTIV CORP
PRZ	PAINCARE HLDGS INC
PTIE	PAIN THERAPEUTICS IN
PLL	PALL CORP
PHHM	PALM HARBOR HOMES
PLMO	PALMONE INC
PMTI	PALOMAR MEDICAL TECH
PNP	PAN PACIFIC RETAIL PPTYS
PA	PANAMSAT HOLDING CORP
PNRA	PANERA BREAD CO
PTRY	PANTRY INC
PZZA	PAPA JOHNS INTERNATIONAL
PTC	PAR TECHNOLOGY CORP
PRX	PAR PHARMACEUTICAL COS
PLLL	PARALLEL PETE CORP
PMTC	PARAMETRIC TECHNOLOGY
PRXL	PAREXEL INTERNATIONAL
PKE	PARK ELECTROCHEMICAL
PRK	PARK NATIONAL CORP
PKD	PARKER DRILLING CO
PH	PARKER HANNIFIN CORP
PKY	PARKWAY PROPERTIES INC
PARL	PARLUX FRAGRANCES INC
PRTR	PARTNERS TRUST FINL GRP
PCTY	PARTY CITY CORP
PTMK	PATHMARK STORES INC
PDCO	PATTERSON COS INC
PTEN	PATTERSON UTI ENERGY
PXR	PAXAR CORP
PAYX	PAYCHEX INC
PSS	PAYLESS SHOESOURCE INC
BTU	PEABODY ENERGY CORP
PGC	PEAPACK-GLADSTONE FINL
PDX	PEDIATRIX MEDICAL GROUP
PEET	PEETS COFFEE & TEA INC
PEGA	PEGASYSTEMS INC
PEGS	PEGASUS SOLUTIONS INC
PENN	PENN NATIONAL GAMING INC
PVA	PENN VIRGINIA CORP
JCP	PENNEY J C INC
PFSB	PENNFED FINANCIAL SVCS
PRFS	PENNROCK FINANCIAL SVCS
COBH	PENNSYLVANIA COMMERCE
PEI	PENNSYLVANIA REAL ESTATE
PNR	PENTAIR INC
PPCO	PENWEST PHARMACEUTICALS
PEBO	PEOPLES BANCORP INC
PBCT	PEOPLES BANK
PGL	PEOPLES ENERGY CORP
PBY	PEP BOYS MANNY MOE&J
POM	PEPCO HOLDINGS INC
PBG	PEPSI BOTTLING GROUP
PAS	PEPSIAMERICAS INC
PEP	PEPSICO INC
PSTI	PER-SE TECHNOLOGIES INC
PFGC	PERFORMANCE FOOD GROUP
PSEM	PERICOM SEMICONDUCTOR
PCR	PERINI CORP
PKI	PERKINELMER INC
PER	PEROT SYSTEMS CORP
PRGO	PERRIGO CO
PETCE	PETCO ANIMAL SUPPLIES
HAWK	PETROHAWK ENERGY CORP
PETD	PETROLEUM DEV CORP
PQUE	PETROQUEST ENERGY INC
PETM	PETSMART INC
PFE	PFIZER INC
PPDI	PHARMACEUTICAL PROD
PHRM	PHARMION CORP
PFWD	PHASE FORWARD INC
PD	PHELPS DODGE CORP
PHLY	PHILADELPHIA CONS HLDG
PVH	PHILLIPS VAN HEUSEN
PNX	PHOENIX COMPANIES INC
PTEC	PHOENIX TECHNOLOGIES LTD
PHTNE	PHOTON DYNAMICS INC
PLAB	PHOTRONICS INC
PNY	PIEDMONT NAT GAS INC
PIR	PIER 1 IMPORTS INC
PPC	PILGRIMS PRIDE CORP
PNCL	PINNACLE AIRL CORP
PNK	PINNACLE ENTMT INC
PNFP	PINNACLE FINANCIAL
PCLE	PINNACLE SYSTEMS INCPNW PINNACLE WEST CAPITAL CO
PONR	PIONEER COMPANIES INC
PDC	PIONEER DRILLING CO
PXD	PIONEER NAT RESOURCES CO
PJC	PIPER JAFFRAY COMPANIES
PBI	PITNEY BOWES INC
PIXR	PIXAR
PXLW	PIXELWORKS INC
PLSB	PLACER SIERRA BANCSHARES
PXP	PLAINS EXPLORATION & PRO
PLT	PLANTRONICS INC
PLA	PLAYBOY ENTERPRISES
PYX	PLAYTEX PRODUCTS INC
PLXS	PLEXUS CORP
PLUG	PLUG POWER INC
PCL	PLUM CREEK TIMBER CO INC
PPP	POGO PRODUCING CO
PII	POLARIS INDUSTRIES INC
RL	POLO RALPH LAUREN CO
PLCM	POLYCOM INC
PLMD	POLYMEDICA CORP
POL	POLYONE CORP
BPOP	POPULAR INC
PLAY	PORTALPLAYER INC
PRAA	PORTFOLIO RECOVERY ASSOC
PPS	POST PROPERTIES INC
PCH	POTLATCH CORP
POWL	POWELL INDUSTRIES INC
POWI	POWER INTEGRATIONS INC
PWER	POWER-ONE INC
PWAV	POWERWAVE TECHNOLOGIES
POZN	POZEN INC
PX	PRAXAIR INC
PPD	PRE PAID LEGAL SERVICES
PCP	PRECISION CASTPARTS
PFBC	PREFERRED BANK
PLPC	PREFORMED LINE PRODUCTS
PCO	PREMCOR INC
PGI	PREMIERE GLOBAL SERVICES
PP	PRENTISS PROPERTIES TR
PLFE	PRESIDENTIAL LIFE CORP
PRWT	PREMIERWEST BANCORP
PRST	PRESSTEK INC
PBH	PRESTIGE BRANDS HOLDINGS
PR	PRICE COMMUNICATIONS
TROW	PRICE T ROWE GROUP INC
PCLN	PRICELINE COM INC
PDE	PRIDE INTERNATIONAL INC
PRM	PRIMEDIA INC
PFG	PRINCIPAL FINANCIAL GRP
PHCC	PRIORITY HEALTHCARE
PRA	PROASSURANCE CORP
PG	PROCTER & GAMBLE CO
PVTB	PRIVATEBANCORP INC
PGNX	PROGENICS PHARMACEUTICAL
PGN	PROGRESS ENERGY INC
PRGS	PROGRESS SOFTWARE CORP
PGR	PROGRESSIVE CORP
PLD	PROLOGIS
PQE	PROQUEST COMPANY
PRSP	PROSPERITY BANCSHARES
PL	PROTECTIVE LIFE CORP
PDLI	PROTEIN DESIGN LABS INC
PRVD	PROVIDE COMMERCE INC
PRSC	PROVIDENCE SERVICE CORP
PBCP	PROVIDENT BANCORP INC
PBKS	PROVIDENT BANKSHARES
PROV	PROVIDENT FINL HLDGS INC
PFS	PROVIDENT FINANCIAL SVCS
PVN	PROVIDIAN FINANCIAL CORP
PRU	PRUDENTIAL FINANCIAL INC
PSYS	PSYCHIATRIC SOLUTIONS
PEG	PUBLIC SVC ENTERPRISE
PSA	PUBLIC STORAGE INC
PSD	PUGET ENERGY INC
PHM	PULTE HOMES INC
QLGC	QLOGIC CORP
QADI	QAD INC
QCCO	QC HOLDINGS INC
QCOM	QUALCOMM INC
QSII	QUALITY SYSTEMS INC
NX	QUANEX CORP
PWR	QUANTA SERVICES INC
QTWW	QUANTUM FUEL SYS TECH
DSS	QUANTUM CORP
DGX	QUEST DIAGNOSTICS INC
QSFT	QUEST SOFTWARE INC
STR	QUESTAR CORP
KWK	QUICKSILVER RESOURCES
ZQK	QUIKSILVER INC
Q	QWEST COMMUNICATIONS
RBIN	R & B INC
RGF	R & G FINANCIAL CORP
RAS	RAIT INVESTMENT TRUST
RCNI	RCN CORP
RCRC	RC2 CORP
RHD	R H DONNELLEY CORP
RLI	RLI CORP
RES	RPC INC
RPM	RPM INTERNATIONAL INC
RSAS	RSA SECURITY INC
RTI	RTI INTERNATIONAL METALS
RFMD	RF MICRODEVICES INC
RDN	RADIAN GROUP INC
RADS	RADIANT SYSTEMS INC
RTSX	RADIATION THERAPY SVCS
ROIAK	RADIO ONE INC
RSH	RADIOSHACK CORP
RSYS	RADISYS CORP
RRA	RAILAMERICA INC
RMBS	RAMBUS INC
RAH	RALCORP HOLDINGS INC
RPT	RAMCO-GERSHENSON PPTYS
RRC	RANGE RESOURCES CORP
RARE	RARE HOSPITALITY INTL
RAVN	RAVEN INDUSTRIES INC
RJF	RAYMOND JAMES FINANCIAL
RYN	RAYONIER INC
RTN	RAYTHEON CO
RDA	READERS DIGEST ASSNRNWK REALNETWORKS INC
O	REALTY INCOME CORP
RA	RECKSON ASSOCS RLTY
RHAT	RED HAT INC
RRGB	RED ROBIN GOURMET BURGER
RBAK	REDBACK NETWORKS INC
RWT	REDWOOD TRUST INC
RBK	REEBOK INTERNATIONAL LTD
RBC	REGAL BELOIT CORP
RGC	REGAL ENTMT GROUP
REG	REGENCY CENTERS CORP
RGCI	REGENT COMMUNICATIONS
REGN	REGENERON PHARMACEUTICAL
RGS	REGIS CORP
RHB	REHABCARE GROUP INC
RF	REGIONS FINANCIAL CORP
RGA	REINSURANCE GRP OF AMER
RS	RELIANCE STEEL & ALUM
RRI	RELIANT ENERGY INC
REM	REMINGTON OIL & GAS
RLRN	RENAISSANCE LEARNING INC
RNST	RENASANT CORP
RNVS	RENOVIS INC
RCI	RENAL CARE GROUP INC
RCII	RENT A CENTER INC
RWY	RENT WAY INC
RJET	REPUBLIC AIRWAYS HLD
RBCAA	REPUBLIC BANCORP INC KY
RBNC	REPUBLIC BANCORP INC MI
RSG	REPUBLIC SERVICES INC
RSCR	RES-CARE INC
RSTO	RESTORATION HARDWARE INC
RMD	RESMED INC
REXI	RESOURCE AMERICA INC
RECN	RESOURCES CONNECTION
RESP	RESPIRONICS INC
RVI	RETAIL VENTURES INC
REV	REVLON INC
REY	REYNOLDS & REYNOLDS
RAI	REYNOLDS AMERICAN INC
RIGL	RIGEL PHARMACEUTICALS
RNOW	RIGHTNOW TECHNOLOGIES
RIMG	RIMAGE CORP
RAD	RITE AID CORP
RIV	RIVIERA HOLDINGS CORP
RESC	ROANOKE ELECTRIC STEEL
RBN	ROBBINS & MYERS INC
RHI	ROBERT HALF INTL INC
RKT	ROCK-TENN CO
ROK	ROCKWELL AUTOMATION INC
RCKB	ROCKVILLE FINL INC
COL	ROCKWELL COLLINS INC
RSTI	ROFIN SINAR TECHNOLOGIES
ROG	ROGERS CORP
ROH	ROHM & HAAS CO
ROL	ROLLINS INC
ROP	ROPER INDUSTRIES INC
ROST	ROSS STORES INC
RDC	ROWAN COMPANIES INC
RBPAA	ROYAL BANCSHARES OF PENN
RGLD	ROYAL GOLD INC
RI	RUBY TUESDAY INC
RDK	RUDDICK CORP
RTEC	RUDOLPH TECHNOLOGIES INC
RUSHA	RUSH ENTERPRISES INC
RUS	RUSS BERRIE & CO INC
RML	RUSSELL CORP
RYAN	RYANS RESTAURANT GROUP
R	RYDER SYSTEM INC
RT	RYERSON TULL INC
RYL	RYLAND GROUP INC
STBA	S & T BANCORP INC
SBC	SBC COMMUNICATIONS INC
SBAC	SBA COMMUNICATIONS CORP
SCBT	SCBT FINANCIAL CORP
POOL	SCP POOL CORP
SEIC	SEI INVESTMENTS CO
SFCC	SFBC INTERNATIONAL INC
SINT	SI INTERNATIONAL INC
SJW	SJW CORP
SLG	SL GREEN REALTY CORP
SLM	SLM CORP
SPSS	SPSS INC
SPW	SPX CORP
SONE	S1 CORPORATION
SRX	SRA INTERNATIONAL INC
SSAG	SSA GLOBAL TECHNOLOGIES
SIVB	SVB FINANCIAL GROUP
SWS	SWS GROUP INC
SYI	S Y BANCORP INC
TSG	SABRE HOLDINGS CORP
SAFC	SAFECO CORP
SFNT	SAFENET INC
SAFT	SAFETY INSURANCE GRP INC
SWY	SAFEWAY INC
SGA	SAGA COMMUNICATIONS
JOE	ST JOE CO
STJ	ST JUDE MEDICAL INC
SM	ST MARY LAND & EXPL CO
STA	ST PAUL TRAVELERS COS
SKS	SAKS INC
SALM	SALEM COMMUNICATIONS
CRM	SALESFORCE COM INC
SLXP	SALIX PHARMACEUTICALS
SMHG	SANDERS MORRIS HARRIS
SAFM	SANDERSON FARMS INC
SNDK	SANDISK CORP
SASR	SANDY SPRING BANCORP
JBSS	SANFILIPPO JOHN B & SON
SANM	SANMINA-SCI CORP
SBP	SANTANDER BANCORP
SAPE	SAPIENT CORP
SLE	SARA LEE CORP
SHS	SAUER-DANFOSS INC
BFS	SAUL CENTERS INC
SVNT	SAVIENT PHARMACEUTICALS
SAX	SAXON CAPITAL INC
SCG	SCANA CORP
SCSC	SCANSOURCE INC
SSFT	SCANSOFT INCSGK SCHAWK INC
HSIC	SCHEIN HENRY INC
SGP	SCHERING PLOUGH CORP
SCHN	SCHNITZER STEEL INDS
SCHL	SCHOLASTIC CORP
SCHS	SCHOOL SPECIALTY INC
SHLM	SCHULMAN A INC
SCH	SCHWAB CHARLES CORP
SWM	SCHWEITZER-MAUDUIT INTL
SFA	SCIENTIFIC ATLANTA INC
SGMS	SCIENTIFIC GAMES CORP
SMG	SCOTTS MIRACLE-GRO CO
SSP	SCRIPPS E W CO
SCST	SCS TRANSPORTATION INC
SEB	SEABOARD CORP
SEAB	SEABRIGHT INSURANCE HLDG
SEAC	SEACHANGE INTERNATIONAL
SBLK	SEABULK INTERNATIONAL
SBCF	SEACOAST BANKING CORP FL
CKH	SEACOR HOLDINGS INC
SEE	SEALED AIR CORP
SHLD	SEARS HOLDINGS CORP
SGEN	SEATTLE GENETICS INC
SCUR	SECURE COMPUTING CORP
SBKC	SECURITY BANK CORP
SBYN	SEEBEYOND TECHNOLOGY
SCSS	SELECT COMFORT CORP
SIGI	SELECTIVE INSURANCE GRP
SMTC	SEMTECH CORP
SRE	SEMPRA ENERGY
SMTL	SEMITOOL INC
SNH	SENIOR HOUSING PPTYS TR
SNMX	SENOMYX INC
SXT	SENSIENT TECHNOLOGIES
SEPR	SEPRACOR INC
SQA.A	SEQUA CORPORATION
SRNA	SERENA SOFTWARE INC
SERO	SEROLOGICALS CORP
SCI	SERVICE CORP INTL
SVM	SERVICEMASTER CO
SE	7-ELEVEN INC
SHRP	SHARPER IMAGE CORP
SGR	SHAW GROUP INC
SHEN	SHENANDOAH TELECOMM CO
SHW	SHERWIN WILLIAMS CO
SCVL	SHOE CARNIVAL INC
SKO	SHOPKO STORES INC
SHFL	SHUFFLE MASTER INC
SHU	SHURGARD STORAGE CENTERS
SEBL	SIEBEL SYSTEMS INC
BSRR	SIERRA BANCORP
SIE	SIERRA HEALTH SERVICES
SRP	SIERRA PACIFIC RESOURCES
SIAL	SIGMA ALDRICH CORP
SGTL	SIGMATEL INC
SBNY	SIGNATURE BANK
SLAB	SILICON LABORATORIES INC
SLGN	SILGAN HOLDINGS INC
SSTI	SILICON STORAGE TECH
SIMG	SILICON IMAGE INC
SFNC	SIMMONS FIRST NATIONAL
SPG	SIMON PROPERTY GROUP INC
SSD	SIMPSON MANUFACTURING
SBGI	SINCLAIR BROADCAST GROUP
SIRI	SIRIUS SATELLITE RADIO
SIRF	SIRF TECHNOLOGY HLDGS
SIR	SIRVA INC
PKS	SIX FLAGS INC
SIZ	SIZELER PPTY INVESTORS
SKX	SKECHERS U S A INC
SKYF	SKY FINANCIAL GROUP INC
SKY	SKYLINE CORP
SKYW	SKYWEST INC
SWKS	SKYWORKS SOLUTIONS INC
SMF	SMART & FINAL INC
AOS	SMITH A O CORP
SII	SMITH INTERNATIONAL INC
SFD	SMITHFIELD FOODS INC
SJM	SMUCKER J M CO
SSCC	SMURFIT-STONE CONTAINER
SNA	SNAP ON INC
SOHU	SOHU COM INC
SLR	SOLECTRON CORP
SMTS	SOMANETICS CORP
SONC	SONIC CORP
SAH	SONIC AUTOMOTIVE INC
SNIC	SONIC SOLUTIONS
SNWL	SONICWALL INC
SON	SONOCO PRODUCTS CO
SONO	SONOSITE INC
BID	SOTHEBYS HOLDINGS INC
SONS	SONUS NETWORKS INC
SFFS	SOUND FEDERAL BANCORP
SORC	SOURCE INTERLINK COS INC
SRCP	SOURCECORP INC
TSFG	SOUTH FINANCIAL GROUP
SJI	SOUTH JERSEY INDUSTRIES
SO	SOUTHERN CO
PCU	SOUTHERN PERU COPPER
SUG	SOUTHERN UNION CO
SBSI	SOUTHSIDE BANCSHARES INC
LUV	SOUTHWEST AIRLINES CO
OKSB	SOUTHWEST BANCORP INC OK
SWX	SOUTHWEST GAS CORP
SWWC	SOUTHWEST WATER CO
SWN	SOUTHWESTERN ENERGY CO
SOV	SOVEREIGN BANCORP INC
SSS	SOVRAN SELF STORAGE
SBSA	SPANISH BROADCASTING SYS
SPTN	SPARTAN STORES INC
SEH	SPARTECH CORP
HDTV	SPATIALIGHT INC
SP	SPECIALTY LABORATORIES
SLNK	SPECTRALINK CORP
SSI	SPECTRASITE INC
SPC	SPECTRUM BRANDS INC
TRK	SPEEDWAY MOTORSPORTS INC
SFN	SPHERION CORP
SKE	SPINNAKER EXPLORATION CO
SFC	SPIRIT FINANCE CORPTSA SPORTS AUTHORITY INC
FON	SPRINT FON GROUP
SSNC	SS&C TECHNOLOGIES INC
STGS	STAGE STORES INC
STMP	STAMPS COM INC
SFG	STANCORP FINANCIAL GROUP
SMSC	STANDARD MICROSYSTEM
SMP	STANDARD MOTOR PRODUCTS
SPF	STANDARD PACIFIC CORP
SR	STANDARD REGISTER CO
SXI	STANDEX INTERNATIONAL
STLY	STANLEY FURNITURE CO INC
SWK	STANLEY WORKS
SPLS	STAPLES INC
STSI	STAR SCIENTIFIC INC
SBUX	STARBUCKS CORP
SRT	STARTEK INC
STFC	STATE AUTO FINANCIAL
STB	STATE BANCORP INC
HOT	STARWOOD HOTELS & RESRTS
SFSW	STATE FINANCIAL SERVICES
STT	STATE STREET CORP
STN	STATION CASINOS INC
SNS	STEAK N SHAKE CO
STLD	STEEL DYNAMICS INC
STTX	STEEL TECHNOLOGIES INC
SCS	STEELCASE INC
SMRT	STEIN MART INC
LVB	STEINWAY MUSICAL INS
STEL	STELLENT INC
STEM	STEMCELLS INC
SCL	STEPAN CO
SBIB	STERLING BANCSHARES
SRCL	STERICYCLE INC
STE	STERIS CORP
STL	STERLING BANCORP
STXS	STEREOTAXIS INC
SLFI	STERLING FINL CORP PA
STSA	STERLING FINL CORP WA
SVC	STEWART & STEVENSON
STEI	STEWART ENTERPRISES
STC	STEWART INFORMATION
SF	STIFEL FINANCIAL CORP
SWC	STILLWATER MINING CO
SGY	STONE ENERGY CORP
STK	STORAGE TECHNOLOGY CORP
SSYS	STRATASYS INC
STGN	STRATAGENE CORP
SLH	STRATEGIC HOTEL CAPITAL
STRT	STRATTEC SECURITY CORP
STRA	STRAYER EDUCATION INC
SRR	STRIDE RITE CORP
SYK	STRYKER CORP
STU	STUDENT LOAN CORP
RGR	STURM RUGER & CO INC
SUBK	SUFFOLK BANCORP
SBIT	SUMMIT BANCSHARES INC
SMMF	SUMMIT FINANCIAL GROUP
SNBC	SUN BANCORP INC NJ
SUI	SUN COMMUNITIES INC
SUNW	SUN MICROSYSTEMS INC
SNHY	SUN HYDRAULICS CORP
SDS	SUNGARD DATA SYSTEMS INC
SUN	SUNOCO INC
SRZ	SUNRISE SENIOR LIVING
SNRR	SUNTERRA CORP
SHO	SUNSTONE HOTEL INVS INC
STI	SUNTRUST BANKS INC
SUPG	SUPERGEN INC
SPN	SUPERIOR ENERGY SERVICES
SPSX	SUPERIOR ESSEX INC
SUP	SUPERIOR INDUSTRIES INTL
SUPX	SUPERTEX INC
SVU	SUPERVALU INC
SPRT	SUPPORTSOFT INC
SURW	SUREWEST COMMUNICATIONS
SRDX	SURMODICS INC
SUSQ	SUSQUEHANNA BANCSHARES
SFY	SWIFT ENERGY CO
SWFT	SWIFT TRANSPORTATION CO
SY	SYBASE INC
SYD	SYBRON DENTAL SPECIALTIE
SCMRE	SYCAMORE NETWORKS INC
SYKE	SYKES ENTERPRISES INC
SYMC	SYMANTEC CORP
SMBI	SYMBION INC DEL
SBL	SYMBOL TECHNOLOGIES
SYMM	SYMMETRICOM INC
SMA	SYMMETRY MEDICAL INC
SYM	SYMS CORP
SMMX	SYMYX TECHNOLOGIES
SYNA	SYNAPTICS INC
SNPS	SYNOPSYS INC
SNV	SYNOVUS FINANCIAL CORP
SYNT	SYNTEL INC
SNX	SYNNEX CORP
SYNM	SYNTROLEUM CORP
SVR	SYNIVERSE HOLDINGS INC
SYPR	SYPRIS SOLUTIONS INC
SYY	SYSCO CORP
SYX	SYSTEMAX INC
TBCC	TBC CORP
TCB	TCF FINANCIAL CORP
BNK	TD BANKNORTH INC
TE	TECO ENERGY INC
THQI	THQ INC
TJX	TJX COMPANIES INC
TRMM	TRM CORP
TRW	TRW AUTOMOTIVE HLDGS
TNS	TNS INC
TTMI	TTM TECHNOLOGIES INC
TXU	TXU CORP
TTWO	TAKE-TWO INTERACTIVE
TLB	TALBOTS INC
TALK	TALK AMERICA HLDGS INC
TALX	TALX CORP
SKT	TANGER FACTORY OUTLET
TNOX	TANOX INC
TGT	TARGET CORP
TARR	TARRAGON CORPTASR TASER INTL INC
TCO	TAUBMAN CENTERS INC
TAYC	TAYLOR CAPITAL GROUP INC
TECD	TECH DATA CORP
TECH	TECHNE CORP
TOA	TECHNICAL OLYMPIC USA
TNL	TECHNITROL INC
TICC	TECHNOLOGY INV CAPITAL
TECUA	TECUMSEH PRODS CO
TRC	TEJON RANCH CO
TKLC	TEKELEC
TEK	TEKTRONIX INC
TDY	TELEDYNE TECHNOLOGIES
TFX	TELEFLEX INC
TDS	TELEPHONE & DATA SYSTEMS
TLWT	TELEWEST GLOBAL INC
TELK	TELIK INC
TKO	TELKONET INC
TLAB	TELLABS INC
TIN	TEMPLE INLAND INC
TTEC	TELETECH HOLDINGS INC
TPX	TEMPUR PEDIC INTL INC
THC	TENET HEALTHCARE CORP
TNC	TENNANT CO
TEN	TENNECO AUTOMOTIVE INC
TER	TERADYNE INC
TERN	TERAYON COMM SYSTEMS INC
TEX	TEREX CORP
TRCA	TERCICA INC
TRA	TERRA INDS INC
TWW	TERREMARK WORLDWIDE INC
TSO	TESORO CORP
TTI	TETRA TECHNOLOGIES INC
TTEK	TETRA TECH INC
TSRA	TESSERA TECHNOLOGIES INC
TCBI	TEXAS CAPITAL BANCSHARES
TXI	TEXAS INDUSTRIES INC
TXN	TEXAS INSTRUMENTS INC
TRBS	TEXAS REGIONAL BANCSHRS
TXRH	TEXAS ROADHOUSE INC
TXT	TEXTRON INC
TMO	THERMO ELECTRON CORP
KOOL	THERMOGENESIS CORP
TNB	THOMAS & BETTS CORP
TII	THOMAS INDUSTRIES INC
THO	THOR INDUSTRIES INC
THOR	THORATEC CORP
TMA	THORNBURG MORTGAGE INC
COMS	3COM CORP
TDSC	3D SYSTEMS CORP
MMM	3M CO
THLD	THRESHOLD PHARMACEUTICAL
TIBX	TIBCO SOFTWARE INC
TDW	TIDEWATER INC
TONE	TIERONE CORP
TBV	TIENS BIOTECH GROUP USA
TIF	TIFFANY & CO
TBL	TIMBERLAND CO
TWX	TIME WARNER INC
TWTC	TIME WARNER TELECOM
TKR	TIMKEN CO
TPY	TIPPERARY CORP
TTN	TITAN CORP
TWI	TITAN INTERNATIONAL INC
TIE	TITANIUM METALS CORP
TIVO	TIVO INC
THE	TODCO
TOL	TOLL BROTHERS INC
TMP	TOMPKINSTRUSTCO INC
TOO	TOO INC
TR	TOOTSIE ROLL INDUSTRIES
TOPP	TOPPS INC
TMK	TORCHMARK CORP
TRGL	TOREADOR RESOURCES CORP
TTC	TORO CO
TWGP	TOWER GROUP INC
TSS	TOTAL SYSTEM SERVICES
TCT	TOWN & COUNTRY TRUST
TOY	TOYS R US INC
TSCO	TRACTOR SUPPLY CO
TRAD	TRADESTATION GROUP INC
TCC	TRAMMELL CROW CO
TWMC	TRANS WORLD ENTMT CORP
TSAI	TRANSACTION SYSTEMS ARCH
TRH	TRANSATLANTIC HLDGS INC
TKTX	TRANSKARYOTIC THERAPIES
TMG	TRANSMONTAIGNE INC
TXCC	TRANSWITCH CORP
TZOO	TRAVELZOO INC
TG	TREDEGAR CORP
TWP	TREX INC
TIV	TRI-VALLEY CORP
TRI	TRIAD HOSPITALS INC
TRID	TRIDENT MICROSYSTEMS INC
TGIC	TRIAD GUARANTY INC
TRY.B	TRIARC COS INC
TRB	TRIBUNE CO
TCBK	TRICO BANCSHARES
TRMB	TRIMBLE NAVIGATION LTD
TRMS	TRIMERIS INC
TRN	TRINITY INDUSTRIES INC
TQNT	TRIQUINT SEMICONDUCTOR
TGI	TRIUMPH GROUP INC
TRZ	TRIZEC PROPERTIES INC
TZIX	TRIZETTO GROUP INC
TPTH	TRIPATH IMAGING INC
TRST	TRUSTCO BANK CORP NY
TRMK	TRUSTMARK CORP
TSY	TRUSTREET PROPERTIES INC
TUES	TUESDAY MORNING CORP
TUP	TUPPERWARE CORP
OVEN	TURBOCHEF TECHNOLOGIES
TW	21ST CENTY INS GROUP
IIVI	II VI INC
TYL	TYLER TECHNOLOGIES INC
TSN	TYSON FOODS INC
UCBH	UCBH HOLDINGS INC
UGI	UGI CORP
UCI	UICI
UIL	UIL HOLDINGS CORPUMBF UMB FINANCIAL CORP
UBH	U S B HOLDING INC
UST	UST INC
USAK	USA TRUCK INC
USB	US BANCORP
URS	URS CORP
USNA	USANA HEALTH SCIENCES
USG	U S G CORP
USU	USEC INC
USIH	U S I HOLDINGS CORP
USPH	U S PHYSICAL THERAPY INC
XPRSA	U S XPRESS ENTERPRISES
UNWR	US UNWIRED INC
USMO	USA MOBILITY INC
UAPH	UAP HOLDING CORP
UPCS	UBIQUITEL INC
ULCM	ULTICOM INC
ULTI	ULTIMATE SOFTWARE GROUP
ULBI	ULTRALIFE BATTERIES INC
UTEK	ULTRATECH INC
UMPQ	UMPQUA HOLDINGS CORP
UNF	UNIFIRST CORP MASS
UBSH	UNION BANKSHARES CORP
UNP	UNION PACIFIC CORP
UB	UNIONBANCAL CORP
UNS	UNISOURCE ENERGY CORP
UIS	UNISYS CORP
UNT	UNIT CORP
UAG	UNITED AUTO GROUP INC
UCFC	UNITED CMNTY FINL CO
UCBI	UNITED COMMUNITY BANKS
UBSI	UNITED BANKSHARES INC
AFP	UNITED CAPITAL CORP
UDI	UNITED DEFENSE INDS INC
UDR	UNITED DOMINION REALTY
UFCS	UNITED FIRE & CAS CO
UIC	UNITED INDUSTRIAL CORP
UNFI	UNITED NATURAL FOODS INC
UNTD	UNITED ONLINE INC
UPFC	UNITED PANAM FINANCIAL
UPS	UNITED PARCEL SERVICE
URI	UNITED RENTALS INC
USBI	UNITED SECURITY BANC INC
USM	UNITED STATES CELLULAR
YSI	U STORE IT TRUST
X	UNITED STATES STEEL CORP
USTR	UNITED STATIONERS INC
USPI	UNITED SURGICAL PARTNERS
UTX	UNITED TECHNOLOGIES
UTHR	UNITED THERAPEUTICS
UNH	UNITEDHEALTH GROUP INC
UTR	UNITRIN INC
UHCO	UNIVERSAL AMERICAN FINL
UCO	UNIVERSAL COMPRESSION
UVV	UNIVERSAL CORP
PANL	UNIVERSAL DISPLAY CORP
UEIC	UNIVERSAL ELECTRONICS
UFPI	UNIVERSAL FOREST PRODS
UHT	UNIVERSAL HEALTH REALTY
UACL	UNIVERSAL TRUCKLOAD SVCS
UHS	UNIVERSAL HEALTH SVCS
UTI	UNIVERSAL TECHNICAL INST
UVN	UNIVISION COMMUNICATIONS
UVSP	UNIVEST CORP OF PENN
UCL	UNOCAL CORP
UNIZ	UNIZAN FINANCIAL CORP
UNA	UNOVA INC
UNM	UNUMPROVIDENT CORP
URBN	URBAN OUTFITTERS INC
UBA	URSTADT BIDDLE PPTYS INS
UTSI	UTSTARCOM INC
WOOF	VCA ANTECH INC
VFC	V F CORP
MTN	VAIL RESORTS INC
VCI	VALASSIS COMMUNICATIONS
VHI	VALHI INC
VLNC	VALENCE TECHNOLOGY INC
VRX	VALEANT PHARMA INTL
VLO	VALERO ENERGY CORP
VLY	VALLEY NATIONAL BANCORP
VMI	VALMONT INDUSTRIES INC
VCG	VALOR COMMUNICATIONS GRP
VAL	VALSPAR CORP
VALU	VALUE LINE INC
VCLK	VALUECLICK INC
VVTV	VALUEVISION MEDIA INC
VARI	VARIAN INC
VSEA	VARIAN SEMICONDUCTOR
VAR	VARIAN MEDICAL SYSTEMS
VDSI	VASCO DATA SECURITY INTL
VVC	VECTREN CORP
VGR	VECTOR GROUP LTD
VECO	VEECO INSTRUMENTS INC
VTR	VENTAS INC
VMSI	VENTANA MEDICAL SYSTEMS
VTIV	VENTIV HEALTH INC
PAY	VERIFONE HLDGS INC
VRTS	VERITAS SOFTWARE CO
VRTY	VERITY INC
VRSN	VERISIGN INC
VTS	VERITAS DGC INC
VZ	VERIZON COMMUNICATIONS
VRNT	VERINT SYSTEMS INC
VRTX	VERTEX PHARMACEUTICALS
VTRU	VERTRUE INC
VIA.B	VIACOM INC
VVI	VIAD CORP
VSAT	VIASAT INC
VAS	VIASYS HEALTHCARE INC
VIAC	VIACELL INC
VICR	VICOR CORP
MICU	VICURON PHARMACEUTICALS
VIGND	VIGNETTE CORP
VISGE	VIISAGE TECHNOLOGY INC
VNBC	VINEYARD NATL BANCORP
VPI	VINTAGE PETROLEUM INC
VIRL	VIRAGE LOGIC CORP
VCBI	VIRGINIA COMM BANCORP
VFGI	VIRGINIA FINANCIAL CORP
VLGC	VIROLOGIC INCVSH VISHAY INTERTECHNOLOGY
VC	VISTEON CORP
VSTA	VISTACARE INC
VITL	VITAL SIGNS INC
VTAL	VITAL IMAGES INC
VTSS	VITESSE SEMICONDUCTOR
VNUS	VNUS MEDICAL TECH INC
VOL	VOLT INFORMATION SCI
VLTR	VOLTERRA SEMICONDUCTOR
VNO	VORNADO REALTY TRUST
VMC	VULCAN MATERIALS CO
WTI	W&T OFFSHORE INC
WDFC	WD-40 CO
WFSI	WFS FINANCIAL INC
WCI	WCI COMMUNITIES INC
WGL	WGL HOLDINGS INC
WHI	W HOLDING CO INC
WHQ	W-H ENERGY SVCS INC
WMS	WMS INDUSTRIES INC
WPS	WPS RESOURCES CORP
WSFS	WSFS FINANCIAL CORP
WNC	WABASH NATIONAL CORP
WAB	WABTEC CORP
WB	WACHOVIA CORP
WDR	WADDELL & REED FINANCIAL
WMT	WAL MART STORES INC
WAG	WALGREEN CO
WLT	WALTER INDUSTRIES INC
WRNC	WARNACO GROUP INC
WMG	WARNER MUSIC GROUP CORP
WRES	WARREN RESOURCES INC
WFSL	WASHINGTON FED INC
WGII	WASHINGTON GROUP INTL
WM	WASHINGTON MUTUAL INC
WPO	WASHINGTON POST CO
WRE	WASHINGTON REAL ESTATE
WASH	WASHINGTON TRUST BANCORP
WCN	WASTE CONNECTIONS INC
WWIN	WASTE INDUSTRIES USA INC
WMI	WASTE MGMT INC
WSII	WASTE SERVICES INC
PIK	WATER PIK TECHNOLOGIES
WAT	WATERS CORP
WSO	WATSCO INC
WPI	WATSON PHARMACEUTICALS
WW	WATSON WYATT & CO HLDGS
WTS	WATTS WATER TECH INC
WPP	WAUSAU PAPER CORP
WEBX	WEBEX INC
WBSN	WEBSENSE INC
WSSI	WEBSIDESTORY INC
WEBM	WEBMETHODS INC
HLTH	WEBMD CORP
WBS	WEBSTER FINANCIAL CORP
WTW	WEIGHT WATCHERS INTL INC
WRI	WEINGARTEN RLTY INVS
WMK	WEIS MARKETS INC
WCG	WELLCARE GROUP INC
WC	WELLCHOICE INC
WLM	WELLMAN INC
WLP	WELLPOINT INC
WFC	WELLS FARGO & CO
WEN	WENDYS INTERNATIONAL INC
WERN	WERNER ENTERPRISES INC
WSBC	WESBANCO INC
WSC	WESCO FINANCIAL CORP
WCC	WESCO INTERNATIONAL INC
WTBA	WEST BANCORPORATION INC
WCBO	WEST COAST BANCORP
WSTC	WEST CORP
WMAR	WEST MARINE INC
WST	WEST PHARMACEUTICAL SVCS
WABC	WESTAMERICA BANCORP
WR	WESTAR ENERGY INC
WSTL	WESTELL TECHNOLOGIES INC
WES	WESTCORP INC
WDC	WESTERN DIGITAL CORP
WGR	WESTERN GAS RESOURCES
WSBA	WESTERN SIERRA BANCORP
WWCA	WESTERN WIRELESS CORP
WFD	WESTFIELD FINANCIAL INC
WLK	WESTLAKE CHEMICAL CORP
WON	WESTWOOD ONE INC
WTSLA	WET SEAL INC
WEYS	WEYCO GROUP INC
WY	WEYERHAEUSER CO
WPSC	WHEELING PITTSBURGH CORP
WHR	WHIRLPOOL CORP
WLL	WHITING PETROLEUM CORP
WTNY	WHITNEY HOLDING CORP
WFMI	WHOLE FOODS MARKET INC
OATS	WILD OATS MARKETS INC
JW.A	WILEY JOHN & SONS INC
WMB	WILLIAMS COMPANIES INC
CWEI	WILLIAMS CLAYTON ENERGY
WSM	WILLIAMS SONOMA INC
WL	WILMINGTON TRUST CORP
WIBC	WILSHIRE BANCORP INC
GB	WILSON GREATBATCH TECH
WLSN	WILSONS THE LEATHER EXP
WIND	WIND RIVER SYSTEMS INC
WGO	WINNEBAGO INDUSTRIES INC
WXH	WINSTON HOTELS INC
WTFC	WINTRUST FINANCIAL CORP
WFII	WIRELESS FACILITIES
WEC	WISCONSIN ENERGY CORP
WITS	WITNESS SYS INC
WWW	WOLVERINE WORLD WIDE
WGOV	WOODWARD GOVERNOR CO
WRLD	WORLD ACCEPTANCE CORP
WLDA	WORLD AIR HOLDINGS INC
INT	WORLD FUEL SVCS CORP
WWE	WORLD WRESTLING ENTMNT
WOR	WORTHINGTON INDUSTRIES
WPTE	WPT ENTERPRISES INC
WXS	WRIGHT EXPRESS CORP
WMGI	WRIGHT MEDICAL GROUP INC
WWY	WRIGLEY WM JR CO
WYE	WYETH
WYNN	WYNN RESORTS LTDXMSR XM SATELLITE RADIO HLDGS
XRIT	X-RITE INC
XTO	XTO ENERGY INC
XEL	XCEL ENERGY INC
XLNX	XILINX INC
XRX	XEROX CORP
XRM	XERIUM TECHNOLOGIES INC
YHOO	YAHOO INC
YCC	YANKEE CANDLE INC
YANB	YARDVILLE NATL BANCORP
YELL	YELLOW ROADWAY CORP
YRK	YORK INTERNATIONAL CORP
YDNT	YOUNG INNOVATIONS INC
YUM	YUM! BRANDS INC
ZLC	ZALE CORP
ZBRA	ZEBRA TECHNOLOGIES CORP
ZNT	ZENITH NATIONAL INS CORP
ZHNE	ZHONE TECHNOLOGIES INC
ZMH	ZIMMER HOLDINGS INC
ZION	ZIONS BANCORPORATION
ZIPR	ZIPREALTY INC
ZRAN	ZORAN CORP
ZOLT	ZOLTEK COMPANIES INC
ZUMZ	ZUMIEZ INC
ZGEN	ZYMOGENETICS INC
ZOLL	ZOLL MEDICAL CORP
