A	AGILENT TECHNOLOGIES IN
AA	ALCOA INC
AAN	AARONS INC
AAON	AAON INC
AAP	ADVANCE AUTO PARTS INC
AAPL	APPLE INC
AAT	AMERICAN ASSETS TRST IN
AATI	ADVANCED ANALOGIC TECH
AAWW	ATLAS AIR WORLDWIDE HLD
ABAX	ABAXIS INC
ABBC	ABINGTON BANCORP INC
ABC	AMERISOURCEBERGEN CORP
ABCB	AMERIS BANCORP
ABCD	CAMBIUM LEARNING GRP IN
ABCO	ADVISORY BOARD CO
ABD	ACCO BRANDS CORP
ABFS	ARKANSAS BEST CORP
ABG	ASBURY AUTOMOTIVE GROUP
ABM	ABM INDUSTRIES INC
ABMD	ABIOMED INC
ABT	ABBOTT LABORATORIES
ABVT	ABOVENET INC
ACAS	AMERICAN CAPITAL LTD
ACAT	ARCTIC CAT INC
ACC	AMERICAN CAMPUS COMMUN
ACCL	ACCELRYS INC
ACE	ACE LTD
ACET	ACETO CORP
ACGL	ARCH CAP GROUP LTD
ACHN	ACHILLION PHARM
ACI	ARCH COAL INC
ACIW	ACI WORLDWIDE INC
ACLS	AXCELIS TECHNOLOGIES IN
ACM	AECOM TECHNOLOGY CORP D
ACN	ACCENTURE PLC IRELAND
ACO	AMCOL INTERNATIONAL COR
ACOM	ANCESTRY.COM INC
ACOR	ACORDA THERAPEUTICS INC
ACPW	ACTIVE POWER INC
ACTG	ACACIA RESEARCH CORP
ACTV	ACTIVE NETWORK INC
ACUR	ACURA PHARMACEUTICALS
ACW	ACCURIDE CORP NEW
ACXM	ACXIOM CORP
ADBE	ADOBE SYSTEMS INC
ADC	AGREE REALTY CORP
ADI	ANALOG DEVICES INC
ADM	ARCHER DANIELS MIDLAND
ADP	AUTOMATIC DATA PROCESS
ADPI	AMERICAN DENTAL PARTNER
ADS	ALLIANCE DATA SYSTEMS
ADSK	AUTODESK INC
ADTN	ADTRAN INC
ADVS	ADVENT SOFTWARE INC
AEA	ADVANCE AMERICA CASH AD
AEC	ASSOCIATED ESTATES RLTY
AEE	AMEREN CORP
AEGR	AEGERION PHARM INC
AEIS	ADVANCED ENERGY INDS IN
AEL	AMERICAN EQUITY INVST
AEO	AMERICAN EAGLE OUTFITTE
AEP	AMERICAN ELECTRIC POWER
AEPI	AEP INDUSTRIES INC
AES	AES CORP
AET	AETNA INC
AF	ASTORIA FINANCIAL CORP
AFAM	ALMOST FAMILY INC
AFCE	AFC ENTERPRISES INC
AFFX	AFFYMETRIX INC
AFFY	AFFYMAX INC
AFG	AMERICAN FINANCIAL GROU
AFL	AFLAC INC
AFP	UNITED CAPITAL CORP
AFSI	AMTRUST FINL SVCS
AGCO	AGCO CORP
AGII	ARGO GROUP INTL
AGL	AGL RESOURCES INC
AGM	FEDERAL AGRIC MTG CO
AGN	ALLERGAN INC
AGNC	AMERICAN CAPITAL AGENCY
AGO	ASSURED GUARANTY LTD
AGP	AMERIGROUP CORP
AGX	ARGAN INC
AGYS	AGILYSYS INC
AH	ACCRETIVE HEALTH INC
AHC	A H BELO CORP
AHL	ASPEN INSURANCE HOLDING
AHS	AMN HEALTHCARE SERVICES
AHT	ASHFORD HOSPITALITY
AI	ARLINGTON ASSET INVT
AIG	AMERICAN INTL GROUP
AIMC	ALTRA HOLDINGS INC
AIN	ALBANY INTERNATIONAL
AINV	APOLLO INVESTMENT CORP
AIQ	ALLIANCE HEALTHCARE SVC
AIR	AAR CORP
AIRM	AIR METHODS CORP
AIS	ANTARES PHARMA INC
AIT	APPLIED INDUSTRIAL TECH
AIV	APARTMENT INVT & MGMT
AIZ	ASSURANT INC
AJG	GALLAGHER ARTHUR J & CO
AKAM	AKAMAI TECHNOLOGIES
AKR	ACADIA REALTY TRUST
AKRX	AKORN INC
AKS	AK STEEL HOLDING CORP
AL	AIR LEASE CORP
ALB	ALBEMARLE CORP
ALC	ASSISTED LIVING CONCPT
ALCO	ALICO INC
ALE	ALLETE INC
ALEX	ALEXANDER & BALDWIN INC
ALG	ALAMO GROUP INC
ALGN	ALIGN TECHNOLOGY INC
ALGT	ALLEGIANT TRAVEL CO
ALIM	ALIMERA SCIENCES INC
ALJ	ALON USA ENERGY INC
ALK	ALASKA AIR GROUP INC
ALKS	ALKERMES INC
ALL	ALLSTATE CORP
ALNC	ALLIANCE FINANCIAL CORP
ALNY	ALNYLAM PHARMACEUTICALS
ALOG	ANALOGIC CORP
ALR	ALERE INC
ALSK	ALASKA COMMUNICATIONS
ALTE	ALTERRA CAPITAL HOLDING
ALTH	ALLOS THERAPEUTICS INC
ALTR	ALTERA CORP
ALV	AUTOLIV INC
ALX	ALEXANDERS INC
ALXN	ALEXION PHARMACEUTICALS
AM	AMERICAN GREETINGS
AMAG	AMAG PHARMACEUTICALS IN
AMAT	APPLIED MATLS INC
AMCC	APPLIED MICRO CIRCUITS
AMD	ADVANCED MICRO DEVICES
AME	AMETEK INC
AMED	AMEDISYS INC
AMG	AFFILIATED MANAGERS GRP
AMGN	AMGEN INC
AMKR	AMKOR TECHNOLOGY INC
AMLN	AMYLIN PHARMACEUTICALS
AMN	AMERON INTERNATIONAL IN
AMP	AMERIPRISE FINANCIAL IN
AMPE	AMPIO PHARMACEUTICALS
AMR	AMR CORP
AMRC	AMERESCO INC
AMRI	ALBANY MOLECULAR RESRCH
AMRS	AMYRIS INC
AMSC	AMERICAN SUPERCONDUCTOR
AMSF	AMERISAFE INC
AMSG	AMSURG CORP
AMSWA	AMERICAN SOFTWARE INC
AMT	AMERICAN TOWER CORP
AMTD	TD AMERITRADE HOLDING
AMWD	AMERICAN WOODMARK CORP
AMZN	AMAZON COM INC
AN	AUTONATION INC
ANAC	ANACOR PHARM INC
ANAD	ANADIGICS INC
ANAT	AMERICAN NATIONAL INS C
ANDE	ANDERSONS INC
ANEN	ANAREN INC
ANF	ABERCROMBIE & FITCH
ANGO	ANGIODYNAMICS INC
ANH	ANWORTH MORTGAGE ASSET
ANN	ANN INC
ANR	ALPHA NATURAL RESOURCES
ANSS	ANSYS INC
ANTH	ANTHERA PHARMACEUTICALS
ANV	ALLIED NEVADA GOLD CORP
AOI	ALLIANCE ONE INTL INC
AOL	AOL INC
AON	AON CORP
AONE	A123 SYSTEMS INC
AOS	SMITH A O CORP
AOSL	ALPHA & OMEGA SEMICON
AP	AMPCO-PITTSBURGH CORP
APA	APACHE CORP
APAC	APAC CUSTOMER SERVICES
APAGF	APCO OIL & GAS INTL INC
APC	ANADARKO PETROLEUM CORP
APD	AIR PRODS & CHEMS INC
APEI	AMER PUBLIC EDUCATION
APH	AMPHENOL CORP
APKT	ACME PACKET INC
APOG	APOGEE ENTERPRISES INC
APOL	APOLLO GROUP INC
ARAY	ACCURAY INC
ARB	ARBITRON INC
ARBA	ARIBA INC
ARC	AMERICAN REPROGRAPHICS
ARCC	ARES CAP CORP
ARCL	ARCHIPELAGO LEARNING IN
ARDNA	ARDEN GROUP INC
ARE	ALEXANDRIA REAL ESTATE
AREX	APPROACH RESOURCES INC
ARG	AIRGAS INC
ARGN	AMERIGON INC
ARI	APOLLO COMMERCIAL RE
ARIA	ARIAD PHARMACEUTICALS
ARII	AMERICAN RAILCAR IND
ARJ	ARCH CHEMICALS INC
ARNA	ARENA PHARMACEUTICALS
ARO	AEROPOSTALE INC
AROW	ARROW FINANCIAL CORP
ARQL	ARQULE INC
ARR	ARMOUR RESIDENTIAL REIT
ARRS	ARRIS GROUP INC
ARRY	ARRAY BIOPHARMA INC
ART	ARTIO GLOBAL INVESTORS
ARTC	ARTHROCARE CORP
ARTNA	ARTESIAN RESOURCES CORP
ARUN	ARUBA NETWORKS INC
ARW	ARROW ELECTRONICS INC
ARX	AEROFLEX HLDG CORP
ASBC	ASSOCIATED BANC CORP
ASCA	AMERISTAR CASINOS INC
ASCMA	ASCENT MEDIA CORP
ASEI	AMERICAN SCIENCE & ENGR
ASGN	ON ASSIGNMENT INC
ASH	ASHLAND INC
ASI	AMERICAN SAFETY INS HLD
ASNA	ASCENA RETAIL GROUP INC
ASTE	ASTEC INDUSTRIES INC
ASYS	AMTECH SYSTEMS INC
AT	ATLANTIC PWR CORP
ATEC	ALPHATEC HOLDINGS
ATHN	ATHENAHEALTH INC
ATI	ALLEGHENY TECHNOLOGIES
ATK	ALLIANT TECHSYSTEMS
ATLO	AMES NATL CORP
ATMI	ATMI INC
ATML	ATMEL CORP
ATNI	ATLANTIC TELE-NETWORK
ATO	ATMOS ENERGY CORP
ATPG	ATP OIL & GAS CORP
ATR	APTARGROUP INC
ATRC	ATRICURE INC
ATRI	ATRION CORP
ATRO	ASTRONICS CORP
ATSG	AIR TRANSPORT SERVICES
ATU	ACTUANT CORP
ATVI	ACTIVISION BLIZZARD INC
ATW	ATWOOD OCEANICS INC
ATX	CROSS A T CO
AUMN	GOLDEN MINERALS CO
AUXL	AUXILIUM PHARMACEUTICAL
AVA	AVISTA CORP
AVAV	AEROVIRONMENT INC
AVB	AVALONBAY CMNTYS INC
AVD	AMERICAN VANGUARD CORP
AVEO	AVEO PHARMACEUTICALS IN
AVGO	AVAGO TECHNOLOGIES LTD
AVID	AVID TECHNOLOGY INC
AVII	AVI BIOPHARMA INC
AVNR	AVANIR PHARMACEUTICALS
AVNW	AVIAT NETWORKS INC
AVP	AVON PRODUCTS INC
AVT	AVNET INC
AVTR	AVATAR HOLDINGS INC
AVX	AVX CORP
AVY	AVERY DENNISON CORP
AWH	ALLIED WRLD ASSUR COM
AWI	ARMSTRONG WORLD INDS IN
AWK	AMERICAN WTR WKS CO INC
AWR	AMERICAN STATES WATER C
AXAS	ABRAXAS PETE CORP
AXE	ANIXTER INTERNATIONAL
AXL	AMERICAN AXLE & MFG
AXP	AMERICAN EXPRESS CO
AXS	AXIS CAPITAL HOLDINGS
AXTI	AXT INC
AYI	ACUITY BRANDS INC
AYR	AIRCASTLE LTD
AZO	AUTOZONE INC
AZPN	ASPEN TECHNOLOGY INC
AZZ	AZZ INC
B	BARNES GROUP INC
BA	BOEING CO
BABY	NATUS MEDICAL INC
BAC	BANK OF AMERICA CORP
BAGL	EINSTEIN NOAH REST GROU
BAH	BOOZ ALLEN HAMILTON HLD
BALT	BALTIC TRADING LIMITED
BANF	BANCFIRST CORP
BANRD	BANNER CORP
BARI	BANCORP RHODE ISLAND IN
BAS	BASIC ENERGY SERVICES
BAX	BAXTER INTERNATIONAL IN
BBBB	BLACKBOARD INC
BBBY	BED BATH & BEYOND INC
BBG	BILL BARRETT CORP
BBND	BIGBAND NETWORKS INC
BBNK	BRIDGE CAPITAL HOLDINGS
BBOX	BLACK BOX CORP
BBRG	BRAVO BRIO RESTAURANT G
BBSI	BARRETT BUSINESS SERVIC
BBT	BB&T CORP
BBW	BUILD A BEAR WORKSHOP
BBY	BEST BUY INC
BC	BRUNSWICK CORP
BCO	BRINKS CO
BCPC	BALCHEM CORP
BCR	BARD C R INC
BCRX	BIOCRYST PHARMACEUTICAL
BCSI	BLUE COAT SYSTEMS INC
BDC	BELDEN INC
BDE	BLACK DIAMOND INC
BDGE	BRIDGE BANCORP INC
BDN	BRANDYWINE REALTY TRUST
BDX	BECTON DICKINSON & CO
BEAT	CARDIONET INC
BEAV	BE AEROSPACE INC
BEBE	BEBE STORES INC
BEC	BECKMAN COULTER INC
BECN	BEACON ROOFING SUPPLY
BEE	STRATEGIC HOTEL & RESOR
BELFB	BEL FUSE INC
BEN	FRANKLIN RESOURCES INC
BEXP	BRIGHAM EXPLORATION
BF.B	BROWN FORMAN CORP
BFIN	BANKFINANCIAL CORP
BFS	SAUL CENTERS INC
BG	BUNGE LIMITED
BGC	GENERAL CABLE CORP
BGCP	BGC PARTNERS INC
BGFV	BIG 5 SPORTING GOODS
BGG	BRIGGS & STRATTON CO
BGMD	BG MEDICINE INC
BGS	B & G FOODS INC
BH	BIGLARI HOLDINGS INC
BHE	BENCHMARK ELECTRONICS
BHI	BAKER HUGHES INC
BHLB	BERKSHIRE HILLS BANCORP
BID	SOTHEBYS
BIG	BIG LOTS INC
BIIB	BIOGEN IDEC INC
BIO	BIO-RAD LABORATORIES IN
BIOS	BIOSCRIP INC
BIRT	ACTUATE CORP
BJ	BJS WHOLESALE CLUB INC
BJRI	BJS RESTAURANTS INC
BK	BANK OF NEW YORK MELLON
BKCC	BLACKROCK KELSO CAP COR
BKD	BROOKDALE SENIOR LIVING
BKE	BUCKLE INC
BKH	BLACK HILLS CORP
BKI	BUCKEYE TECHNOLOGIES IN
BKMU	BANK MUTUAL CORP
BKR	BAKER MICHAEL CORP
BKS	BARNES & NOBLE INC
BKU	BANKUNITED INC
BKYF	BANK KY FINL CORP
BLC	BELO CORP
BLDR	BUILDERS FIRSTSOURCE IN
BLK	BLACKROCK INC
BLKB	BLACKBAUD INC
BLL	BALL CORP
BLT	BLOUNT INTERNATIONAL IN
BLTI	BIOLASE TECHNOLOGY INC
BLUD	IMMUCOR INC
BLX	BANCO LATINOAMERICANO
BMC	BMC SOFTWARE INC
BMI	BADGER METER INC
BMR	BIOMED REALTY TRUST INC
BMRC	BANK OF MARIN BANCORP
BMRN	BIOMARIN PHARMACEUTICAL
BMS	BEMIS INC
BMTC	BRYN MAWR BANK CORP
BMTI	BIOMIMETIC THERAPEUTICS
BMY	BRISTOL MYERS SQUIBB
BNCL	BENEFICIAL MUTUAL INC
BNHNA	BENIHANA INC
BOBE	BOB EVANS FARMS INC
BODY	BODY CENTRAL CORP
BOFI	BOFI HLDG INC
BOH	BANK OF HAWAII CORP
BOKF	BOK FINANCIAL CORP
BONE	BACTERIN INTL HLDGS INC
BONT	BON-TON STORES INC
BOOM	DYNAMIC MATERIALS CORP
BOX	SEACUBE CONTAINER LEASI
BPAX	BIOSANTE PHARMACEUTICAL
BPFH	BOSTON PRIVATE FINANCIA
BPI	BRIDGEPOINT ED INC
BPOP	POPULAR INC
BPZ	BPZ RESOURCES INC
BR	BROADRIDGE FINANCIAL IN
BRC	BRADY CORP
BRCD	BROCADE COMMUNICATIONS
BRCM	BROADCOM CORP
BRE	BRE PROPERTIES INC
BRK.B	BERKSHIRE HATHAWAY INC
BRKL	BROOKLINE BANCORP INC
BRKR	BRUKER CORP
BRKS	BROOKS AUTOMATION INC
BRLI	BIO-REFERENCE LABS INC
BRO	BROWN & BROWN INC
BRS	BRISTOW GROUP INC
BRY	BERRY PETROLEUM CO
BSFT	BROADSOFT INC
BSRR	SIERRA BANCORP
BSTC	BIOSPECIFICS TECHNO COR
BSX	BOSTON SCIENTIFIC CO
BTH	BLYTH INC
BTU	PEABODY ENERGY CORP
BTX	BIOTIME INC
BUCY	BUCYRUS INTERNATIONAL
BUSE	FIRST BUSEY CORP
BWA	BORG WARNER INC
BWC	BABCOCK & WILCOX COMPAN
BWEN	BROADWIND ENERGY INC
BWINB	BALDWIN & LYONS INC
BWLD	BUFFALO WILD WINGS INC
BWS	BROWN SHOE INC
BXP	BOSTON PROPERTIES INC
BXS	BANCORPSOUTH INC
BYD	BOYD GAMING CORP
BYI	BALLY TECHNOLOGIES INC
BZ	BOISE INC
BZH	BEAZER HOMES USA INC
C	CITIGROUP INC
CA	CA INC
CAB	CABELAS INC
CAC	CAMDEN NATIONAL CORP
CACB	CASCADE BANCORP
CACC	CREDIT ACCEP CORP MICH
CACI	CACI INTERNATIONAL INC
CADX	CADENCE PHARMACEUTICALS
CAG	CONAGRA FOODS INC
CAH	CARDINAL HEALTH INC
CAK	CAMAC ENERGY INC
CAKE	CHEESECAKE FACTORY INC
CALD	CALLIDUS SOFTWARE INC
CALM	CAL MAINE FOODS INC
CALP	CALIPER LIFE SCIENCES
CALX	CALIX INC
CAM	CAMERON INTL CORP
CAP	CAI INTERNATIONAL INC
CAR	AVIS BUDGET GROUP INC
CAS	CASTLE A M & CO
CASC	CASCADE CORP
CASS	CASS INFORMATION SYSTEM
CASY	CASEYS GENERAL STORES
CAT	CATERPILLAR INC
CATM	CARDTRONICS INC
CATO	CATO CORP
CATY	CATHAY GENERAL BANCORP
CAVM	CAVIUM INC
CB	CHUBB CORP
CBB	CINCINNATI BELL INC
CBE	COOPER INDUSTRIES PLC
CBEY	CBEYOND INC
CBG	CB RICHARD ELLIS GROUP
CBI	CHICAGO BRIDGE & IRON
CBK	CHRISTOPHER & BANKS COR
CBKN	CAPITAL BK CORP
CBL	CBL & ASSOC PPTYS INC
CBLI	CLEVELAND BIOLABS INC
CBM	CAMBREX CORP
CBNJ	CAPE BANCORP INC
CBOE	CBOE HLDGS INC
CBOU	CARIBOU COFFEE CO INC
CBR	CIBER INC
CBRL	CRACKER BARREL STORE
CBRX	COLUMBIA LABORATORIES
CBS	CBS CORPORATION
CBSH	COMMERCE BANCSHARES INC
CBST	CUBIST PHARMACEUTICALS
CBT	CABOT CORP
CBU	COMMUNITY BANK SYSTEMS
CBZ	CBIZ INC
CCBG	CAPITAL CITY BANK GROUP
CCC	CALGON CARBON CORP
CCE	COCA COLA ENTERPRISE
CCF	CHASE CORP
CCG	CAMPUS CREST CMNTYS INC
CCI	CROWN CASTLE INTL CORP
CCIX	COLEMAN CABLE INC
CCK	CROWN HOLDINGS INC
CCL	CARNIVAL CORP
CCMP	CABOT MICROELECTRONICS
CCNE	CNB FINL CORP PA
CCO	CLEAR CHANNEL OUTDOOR
CCOI	COGENT COMMUNICATIONS
CCRN	CROSS COUNTRY HEALTHCAR
CDE	COEUR D ALENE MINES COR
CDI	CDI CORP
CDNS	CADENCE DESIGN SYSTEMS
CDR	CEDAR SHOPPING CTRS INC
CDXS	CODEXIS INC
CDZI	CADIZ INC
CE	CELANESE CORP
CEC	CEC ENTMT INC
CECO	CAREER EDUCATION CORP
CEDC	CENTRAL EUROPEAN DISTRI
CEG	CONSTELLATION ENERGY GR
CELG	CELGENE CORP
CELL	BRIGHTPOINT INC
CENTA	CENTRAL GARDEN & PET CO
CENX	CENTURY ALUMINUM CO
CEPH	CEPHALON INC
CERN	CERNER CORP
CERS	CERUS CORP
CETV	CENTRAL EUROPEAN MEDIA
CEVA	CEVA INC
CF	CF INDUSTRIES HOLDINGS
CFFN	CAPITOL FEDERAL FINL IN
CFN	CAREFUSION CORP
CFNB	CALIFORNIA FIRST NATL
CFNL	CARDINAL FINANCIAL CORP
CFR	CULLEN FROST BANKERS
CFX	COLFAX CORP
CGI	CELADON GROUP INC
CGNX	COGNEX CORP
CGX	CONSOLIDATED GRAPHIC
CHCO	CITY HOLDING CO
CHD	CHURCH & DWIGHT INC
CHDN	CHURCHILL DOWNS INC
CHDX	CHINDEX INTERNATIONAL
CHE	CHEMED CORPORATION
CHFC	CHEMICAL FINANCIAL CORP
CHFN	CHARTER FINL CORP WEST
CHG	CH ENERGY GROUP INC
CHH	CHOICE HOTELS INTL INC
CHK	CHESAPEAKE ENERGY CORP
CHKE	CHEROKEE INC
CHMT	CHEMTURA CORP
CHRS	CHARMING SHOPPES INC
CHRW	C H ROBINSON WORLDWIDE
CHS	CHICOS FAS INC
CHSI	CATALYST HLTH SOLUTIONS
CHSP	CHESAPEAKE LODGING TRUS
CHTP	CHELSEA THERAPEUTICS IN
CHTR	CHARTER COMM INC
CHUX	O CHARLEYS INC
CI	CIGNA CORP
CIA	CITIZENS INC
CIE	COBALT INTL ENERGY
CIEN	CIENA CORP
CIGX	STAR SCIENTIFIC INC
CIM	CHIMERA INVESTMENT CORP
CINF	CINCINNATI FINANCIAL
CIR	CIRCOR INTERNATIONAL IN
CIT	CIT GROUP INC
CIX	COMPX INTERNATIONAL
CKH	SEACOR HOLDINGS INC
CKP	CHECKPOINT SYSTEMS INC
CL	COLGATE PALMOLIVE CO
CLB	CORE LABORATORIES N V
CLC	CLARCOR INC
CLD	CLOUD PEAK ENERGY INC
CLDT	CHATHAM LODGING TR
CLDX	CELLDEX THERAPEUTICS IN
CLF	CLIFFS NATURAL RESOURCE
CLFC	CENTER FINANCIAL CORP
CLGX	CORELOGIC INC
CLH	CLEAN HARBORS INC
CLI	MACK CALI REALTY CORP
CLMS	CALAMOS ASSET MGMT INC
CLNE	CLEAN ENERGY FUELS CORP
CLNY	COLONY FINANCIAL INC
CLP	COLONIAL PROPERTIES TR
CLR	CONTINENTAL RESOURCES I
CLUB	TOWN SPORTS INTL
CLW	CLEARWATER PAPER CORP
CLWR	CLEARWIRE CORP
CLX	CLOROX CO
CMA	COMERICA INC
CMC	COMMERCIAL METALS CO
CMCO	COLUMBUS MCKINNON CORP
CMCSA	COMCAST CORP
CME	CME GROUP INC
CMG	CHIPOTLE MEXICAN GRILL
CMI	CUMMINS INC
CMLS	CUMULUS MEDIA INC
CMN	CANTEL MEDICAL CORP
CMO	CAPSTEAD MORTGAGE CORP
CMP	COMPASS MINERALS INTL
CMRG	CASUAL MALE RETAIL GROU
CMS	CMS ENERGY CORP
CMTL	COMTECH TELECOMM
CNA	CNA FINANCIAL CORP
CNBC	CENTER BANCORP INC
CNBKA	CENTURY BANCORP INC
CNC	CENTENE CORP
CNH	CNH GLOBAL N V
CNK	CINEMARK HOLDINGS INC
CNL	CLECO CORP
CNMD	CONMED CORP
CNO	CNO FINANCIAL GROUP
CNP	CENTERPOINT ENERGY INC
CNQR	CONCUR TECHNOLOGIES INC
CNS	COHEN & STEERS INC
CNSL	CONSOLIDATED COMM
CNU	CONTINUCARE CORP
CNVO	CONVIO INC
CNW	CON-WAY INC
CNX	CONSOL ENERGY INC
COBZ	COBIZ FINANCIAL INC
COCO	CORINTHIAN COLLEGES INC
CODE	SPANSION INC
CODI	COMPASS DIVERSIFIED HLD
COF	CAPITAL ONE FINANCIAL
COG	CABOT OIL & GAS CORP
COH	COACH INC
COHR	COHERENT INC
COHU	COHU INC
COKE	COCA COLA BOTTLING
COL	ROCKWELL COLLINS INC
COLB	COLUMBIA BKG SYSTEM INC
COLM	COLUMBIA SPORTSWEAR CO
CONN	CONNS INC
COO	COOPER COMPANIES INC
COP	CONOCOPHILLIPS
COR	CORESITE REALTY CORP
CORE	CORE MARK HOLDING CO IN
CORT	CORCEPT THERAPEUTICS IN
COST	COSTCO WHOLESALE CORP
COV	COVIDIEN PLC
COWN	COWEN GROUP INC
CPA	COPA HOLDINGS SA
CPB	CAMPBELL SOUP CO
CPE	CALLON PETROLEUM CO
CPF	CENTRAL PACIFIC FINL
CPHD	CEPHEID INC
CPK	CHESAPEAKE UTILITIES
CPKI	CALIFORNIA PIZZA KITCHE
CPLA	CAPELLA EDUCATION CO
CPN	CALPINE CORP
CPO	CORN PRODS INTERNATIONA
CPRT	COPART INC
CPSI	COMPUTER PROGRAMS & SYS
CPST	CAPSTONE TURBINE CORP
CPT	CAMDEN PROPERTY TRUST
CPTS	CONCEPTUS INC
CPWM	COST PLUS INC
CPWR	COMPUWARE CORP
CPX	COMPLETE PRODUCTION SER
CQB	CHIQUITA BRANDS INTL IN
CR	CRANE CO
CRAI	CRA INTERNATIONAL INC
CRAY	CRAY INC
CRD.B	CRAWFORD & CO
CRDN	CERADYNE INC
CREE	CREE INC
CRI	CARTER INC
CRIS	CURIS INC
CRK	COMSTOCK RESOURCES INC
CRL	CHARLES RIVER LABS INTL
CRM	SALESFORCE COM INC
CRMT	AMERICAS CAR-MART INC
CROX	CROCS INC
CRR	CARBO CERAMICS INC
CRRC	COURIER CORP
CRS	CARPENTER TECHNOLOGY
CRTX	CORNERSTONE THERAPEUTIC
CRUS	CIRRUS LOGIC INC
CRVL	CORVEL CORP
CRWN	CROWN MEDIA HOLDINGS IN
CRY	CRYOLIFE INC
CRZO	CARRIZO OIL & GAS INC
CSA	COGDELL SPENCER INC
CSBK	CLIFTON SVGS BANCORP IN
CSC	COMPUTER SCIENCES CORP
CSCO	CISCO SYSTEMS INC
CSE	CAPITALSOURCE INC
CSFL	CENTERSTATE BANKS INC
CSGP	COSTAR GROUP INC
CSGS	CSG SYSTEMS INTL INC
CSH	CASH AMERICA INTL INC
CSII	CARDIOVASCULAR SYS INC
CSL	CARLISLE COS INC
CSOD	CORNERSTONE ONDEMAND IN
CSS	CSS INDUSTRIES INC
CSTR	COINSTAR INC
CSU	CAPITAL SENIOR LIVING
CSWC	CAPITAL SOUTHWEST CORP
CSX	CSX CORP
CTAS	CINTAS CORP
CTB	COOPER TIRE & RUBBER CO
CTBI	COMMUNITY TRUST BANCORP
CTCT	CONSTANT CONTACT INC
CTGX	COMPUTER TASK GROUP INC
CTIC	CELL THERAPEUTICS INC
CTL	CENTURYLINK INC
CTO	CONSOLIDATED TOMOKA LAN
CTRN	CITI TRENDS INC
CTS	CTS CORP
CTSH	COGNIZANT TECH SOLUTION
CTWS	CONNECTICUT WATER SVC
CTXS	CITRIX SYSTEMS INC
CUB	CUBIC CORP
CUZ	COUSINS PROPERTIES INC
CV	CENTRAL VERMONT PUB SVC
CVA	COVANTA HOLDING CORP
CVBF	CVB FINANCIAL CORP
CVC	CABLEVISION SYSTEMS COR
CVCO	CAVCO INDUSTRIES INC
CVD	COVANCE INC
CVG	CONVERGYS CORP
CVGI	COMMERCIAL VEH GROUP IN
CVGW	CALAVO GROWERS INC
CVH	COVENTRY HEALTH CARE
CVI	CVR ENERGY INC
CVLT	COMMVAULT SYSTEMS INC
CVO	CENVEO INC
CVS	CVS/CAREMARK CORP
CVTI	COVENANT TRANS GRP INC
CVX	CHEVRON CORP
CW	CURTISS WRIGHT CORP
CWCO	CONSOLIDATED WATER CO
CWEI	WILLIAMS CLAYTON ENERGY
CWH	COMMONWEALTH REIT
CWST	CASELLA WASTE SYSTEMS
CWT	CALIFORNIA WTR SVC GRP
CWTR	COLDWATER CREEK INC
CXO	CONCHO RESOURCES INC
CXPO	CRIMSON EXPLORATION INC
CXS	CREXUS INVESTMENT CORP
CXW	CORRECTIONS CORP OF AME
CY	CYPRESS SEMICONDUCTOR
CYBX	CYBERONICS INC
CYH	COMMUNITY HEALTH SYSTEM
CYMI	CYMER INC
CYN	CITY NATIONAL CORP
CYNO	CYNOSURE INC
CYS	CYPRESS SHARPRIDGE INV
CYT	CYTEC INDUSTRIES INC
CYTX	CYTORI THERAPEUTICS INC
CZNC	CITIZENS & NORTHERN COR
D	DOMINION RESOURCES INC
DAKT	DAKTRONICS INC
DAL	DELTA AIR LINES INC DEL
DAN	DANA HOLDING CORP
DAR	DARLING INTERNATIONAL
DBD	DIEBOLD INC
DCI	DONALDSON INC
DCO	DUCOMMUN INC
DCOM	DIME CMNTY BANCSHARES
DCT	DCT INDUSTRIAL TRUST IN
DCTH	DELCATH SYS INC
DD	DU PONT E I DE NEMOURS
DDD	3D SYSTEMS CORP
DDIC	DDI CORP
DDR	DEVELOPERS DIVERSIFIED
DDS	DILLARDS INC
DE	DEERE & CO
DECK	DECKERS OUTDOOR CORP
DEI	DOUGLAS EMMETT INC
DEL	DELTIC TIMBER CORP
DELL	DELL INC
DENN	DENNYS CORP
DEPO	DEPOMED INC
DEST	DESTINATION MATERNITY
DF	DEAN FOODS COMPANY
DFG	DELPHI FINANCIAL GRP IN
DFR	CIFC DEERFIELD CORP
DFS	DISCOVER FINANCIAL SRVC
DFT	DUPONT FABROS TECHNOLOG
DFZ	BARRY R G CORP OHIO
DG	DOLLAR GENERAL CORP
DGI	DIGITALGLOBE INC
DGICA	DONEGAL GROUP INC
DGII	DIGI INTL INC
DGIT	DG FASTCHANNEL INC
DGX	QUEST DIAGNOSTICS INC
DHI	D R HORTON INC
DHIL	DIAMOND HILL INVESTMENT
DHR	DANAHER CORP
DHT	DHT HOLDINGS INC
DHX	DICE HOLDINGS INC
DIN	DINEEQUITY INC
DIOD	DIODES INC
DIS	DISNEY WALT CO
DISCA	DISCOVERY COMMUNICATNS
DISH	DISH NETWORK CORP
DK	DELEK US HLDGS INC
DKS	DICKS SPORTING GOODS IN
DLA	DELTA APPAREL INC
DLB	DOLBY LABORATORIES INC
DLGC	DIALOGIC INC
DLLR	DOLLAR FINANCIAL CORP
DLR	DIGITAL REALTY TRUST IN
DLTR	DOLLAR TREE INC
DLX	DELUXE CORP
DM	DOLAN COMPANY
DMAN	DEMANDTEC INC
DMD	DEMAND MEDIA INC
DMND	DIAMOND FOODS INC
DMRC	DIGIMARC CORPORATION
DNB	DUN & BRADSTREET CORP
DNBK	DANVERS BANCORP INC
DNDN	DENDREON CORP
DNR	DENBURY RESOURCES INC
DO	DIAMOND OFFSHR DRILLING
DOLE	DOLE FOOD CO INC
DORM	DORMAN PRODUCTS INC
DOV	DOVER CORP
DOW	DOW CHEMICAL CO
DOX	AMDOCS LTD
DPL	DPL INC
DPS	DR PEPPER SNAPPLE GROUP
DPZ	DOMINOS PIZZA INC
DRC	DRESSER-RAND GROUP INC
DRCO	DYNAMICS RESEARCH CORP
DRE	DUKE REALTY CORP
DRH	DIAMONDROCK HOSPITALITY
DRI	DARDEN RESTAURANTS INC
DRIV	DIGITAL RIVER INC
DRL	DORAL FINANCIAL CORP
DRQ	DRIL-QUIP INC
DRRX	DURECT CORP
DSPG	DSP GROUP INC
DST	DST SYSTEMS INC
DSW	DSW INC
DTE	DTE ENERGY CO
DTG	DOLLAR THRIFTY AUTO
DTSI	DTS INC
DTV	DIRECTV GROUP INC
DUF	DUFF & PHELPS CORP
DUK	DUKE ENERGY CORP
DUSA	DUSA PHARMACEUTICALS IN
DV	DEVRY INC
DVA	DAVITA INC
DVAX	DYNAVAX TECHNOLOGIES
DVN	DEVON ENERGY CORP
DVOX	DYNAVOX INC
DVR	CAL DIVE INTL INC
DW	DREW INDUSTRIES INC
DWA	DREAMWORKS ANIMATION SK
DWSN	DAWSON GEOPHYSICAL CO
DX	DYNEX CAPITAL INC
DXCM	DEXCOM INC
DXPE	DXP ENTERPRISES INC NEW
DY	DYCOM INDUSTRIES INC
DYAX	DYAX CORP
DYN	DYNEGY INC
EAT	BRINKER INTERNATIONAL
EBAY	EBAY INC
EBF	ENNIS INC
EBIX	EBIX INC
EBS	EMERGENT BIOSOLUTIONS
EBSB	MERIDIAN INTERSTATE
EBTC	ENTERPRISE BANCORP INC
EBTX	ENCORE BANCSHARES INC
ECHO	ECHO GLOBAL LOGISTICS
ECL	ECOLAB INC
ECOL	US ECOLOGY INC
ECPG	ENCORE CAPITAL GROUP IN
ECYT	ENDOCYTE INC
ED	CONSOLIDATED EDISON INC
EDE	EMPIRE DISTRICT ELECTRI
EDMC	EDUCATION MGMT CORP
EDR	EDUCATION REALTY TRUST
EE	EL PASO ELECTRIC CO
EEFT	EURONET WORLDWIDE INC
EF	EDELMAN FINANCIAL GROUP
EFII	ELECTRONICS FOR IMAGING
EFSC	ENTERPRISE FINL SERVICE
EFX	EQUIFAX INC
EGBN	EAGLE BANCORP INC
EGHT	8X8 INC NEW
EGLE	EAGLE BULK SHIPPING INC
EGN	ENERGEN CORP
EGOV	NIC INC
EGP	EASTGROUP PROPERTIES IN
EGY	VAALCO ENERGY INC
EHTH	EHEALTH INC
EIG	EMPLOYERS HOLDINGS INC
EIX	EDISON INTERNATIONAL
EK	EASTMAN KODAK CO
EL	ESTEE LAUDER COMPANIES
ELGX	ENDOLOGIX INC
ELLI	ELLIE MAE INC
ELMG	EMS TECHNOLOGIES INC
ELNK	EARTHLINK INC
ELON	ECHELON CORP
ELRC	ELECTRO RENT CORP
ELS	EQUITY LIFESTYLE PROP
ELX	EMULEX CORP
ELY	CALLAWAY GOLF CO
EM	EMDEON INC
EMAN	EMAGIN CORP
EMC	E M C CORP
EMCI	EMC INS GROUP INC
EME	EMCOR GROUP INC
EMKR	EMCORE CORP
EMN	EASTMAN CHEMICAL CO
EMR	EMERSON ELECTRIC CO
END	ENDEAVOUR INTERNATIONAL
ENDP	ENDO PHARMACEUTICALS
ENH	ENDURANCE SPECIALTY HLD
ENOC	ENERNOC INC
ENR	ENERGIZER HOLDINGS INC
ENS	ENERSYS INC
ENSG	ENSIGN GROUP INC
ENTG	ENTEGRIS INC
ENTR	ENTROPIC COMMUNICATIONS
ENV	ENVESTNET INC
ENZ	ENZO BIOCHEM INC
ENZN	ENZON PHARMACEUTICALS
EOG	EOG RESOURCES INC
EP	EL PASO CORP
EPAX	AMBASSADORS GROUP INC
EPAY	BOTTOMLINE TECHNOLOGIES
EPHC	EPOCH HOLDING CORP
EPIQ	EPIQ SYSTEMS INC
EPL	ENERGY PARTNERS LTD
EPM	EVOLUTION PETROLEUM COR
EPOC	EPOCRATES INC
EPR	ENTERTAINMENT PPTYS TR
EQIX	EQUINIX INC
EQR	EQUITY RESIDENTIAL
EQT	EQT CORPORATION
EQY	EQUITY ONE INC
ERIE	ERIE INDEMNITY CO
ERII	ENERGY RECOVERY INC
ERT	ERESEARCHTECHNOLOGY INC
ERTS	ELECTRONIC ARTS INC
ES	ENERGYSOLUTIONS INC
ESBF	ESB FINANCIAL CORP
ESC	EMERITUS CORP
ESE	ESCO TECHNOLOGIES INC
ESGR	ENSTAR GROUP LIMITED
ESI	ITT EDUCATIONAL SVCS IN
ESIO	ELECTRO SCIENTIFIC INDS
ESL	ESTERLINE TECHNOLOGIES
ESRX	EXPRESS SCRIPTS INC
ESS	ESSEX PROPERTY TRUST IN
ESSA	ESSA BANCORP INC
ESSX	ESSEX RENT CORP
ETFC	E TRADE FINANCIAL CORP
ETH	ETHAN ALLEN INTERIORS
ETM	ENTERCOM COMMUNICATIONS
ETN	EATON CORP
ETR	ENTERGY CORP
EV	EATON VANCE CORP
EVC	ENTRAVISION COMM
EVR	EVERCORE PARTNERS
EW	EDWARDS LIFESCIENCES
EWBC	EAST WEST BANCORP INC
EXAC	EXACTECH INC
EXAM	EXAMWORKS GROUP INC
EXAR	EXAR CORP
EXAS	EXACT SCIENCES CORP
EXBD	CORPORATE EXECUTIVE
EXC	EXELON CORP
EXEL	EXELIXIS INC
EXH	EXTERRAN HOLDINGS INC
EXL	EXCEL TR INC
EXLS	EXLSERVICE HOLDINGS INC
EXM	EXCEL MARITIME CARRIERS
EXP	EAGLE MATERIALS INC
EXPD	EXPEDITORS INTL OF WASH
EXPE	EXPEDIA INC
EXPO	EXPONENT INC
EXPR	EXPRESS INC
EXR	EXTRA SPACE STORAGE INC
EXTR	EXTREME NETWORKS INC
EXXI	ENERGY XXI (BERMUDA) LT
EZPW	EZCORP INC
F	FORD MOTOR CO
FAF	FIRST AMERICAN FINL COR
FALC	FALCONSTOR SOFTWARE
FARM	FARMER BROS CO
FARO	FARO TECHNOLOGIES INC
FAST	FASTENAL CO
FBC	FLAGSTAR BANCORP INC
FBCM	FBR & CO
FBN	FURNITURE BRANDS INTL
FBNC	FIRST BANCORP NC
FC	FRANKLIN COVEY CO
FCBC	FIRST CMNTY BANCSHAR
FCE.A	FOREST CITY ENTRPRS
FCEL	FUELCELL ENERGY INC
FCF	FIRST COMMONWLTH FINL
FCFS	FIRST CASH FINANCIAL
FCH	FELCOR LODGING TRUST IN
FCN	FTI CONSULTING INC
FCNCA	FIRST CITIZENS BANCSHRS
FCS	FAIRCHILD SEMICONDUCTOR
FCX	FREEPORT-MCMORAN C&G
FDEF	FIRST DEFIANCE FINANCIA
FDML	FEDERAL MOGUL CORP
FDO	FAMILY DOLLAR STORES
FDP	FRESH DEL MONTE PRODUCE
FDS	FACTSET RESEARCH SYSTEM
FDX	FEDEX CORP
FE	FIRSTENERGY CORP
FEIC	FEI CO
FELE	FRANKLIN ELECTRIC CO
FF	FUTUREFUEL CORPORATION
FFBC	FIRST FINANCIAL BANCORP
FFCH	FIRST FINANCIAL HOLDING
FFG	FBL FINANCIAL GROUP INC
FFIC	FLUSHING FINANCIAL CORP
FFIN	FIRST FINL BANKSHARES
FFIV	F5 NETWORKS INC
FFN	FRIENDFINDER NETWORKS
FHCO	FEMALE HEALTH CO
FHN	FIRST HORIZON NATL CORP
FIBK	FIRST INTST BANCSYSTEM
FICO	FAIR ISAAC CORP
FII	FEDERATED INVESTORS INC
FINL	FINISH LINE INC
FIRE	SOURCEFIRE INC
FIS	FIDELITY NATL INFO SVCS
FISI	FINANCIAL INSTNS INC
FISV	FISERV INC
FITB	FIFTH THIRD BANCORP
FIX	COMFORT SYSTEMS USA INC
FIZZ	NATIONAL BEVERAGE CORP
FL	FOOT LOCKER INC
FLDM	FLUIDIGM CORP
FLIC	FIRST LONG ISLAND CORP
FLIR	FLIR SYSTEMS INC
FLO	FLOWERS FOODS INC
FLOW	FLOW INTL CORP
FLR	FLUOR CORP
FLS	FLOWSERVE CORP
FLT	FLEETCOR TECHNOLOGIES
FLWS	1-800 FLOWERS COM
FMBI	FIRST MIDWEST BANCORP
FMC	FMC CORP
FMD	FIRST MARBLEHEAD CORP
FMER	FIRSTMERIT CORP
FN	FABRINET
FNB	FNB CORP
FNF	FIDELITY NATIONAL FINL
FNFG	FIRST NIAGARA FINL GRP
FNGN	FINANCIAL ENGINES INC
FNLC	FIRST BANCORP INC
FNSR	FINISAR CORP
FO	FORTUNE BRANDS INC
FOE	FERRO CORP
FOLD	AMICUS THERAPEUTICS INC
FOR	FORESTAR GROUP INC
FORM	FORMFACTOR INC
FORR	FORRESTER RESEARCH INC
FOSL	FOSSIL INC
FPIC	FPIC INSURANCE GROUP IN
FPO	FIRST POTOMAC REALTY TR
FPTB	FIRST PACTRUST BANCORP
FR	FIRST INDUSTRIAL RLTY T
FRC	FIRST REP BK SAN FRAN
FRED	FREDS INC
FRF	FORTEGRA FINANCIAL CORP
FRM	FURMANITE CORP
FRME	FIRST MERCHANTS CORP
FRNK	FRANKLIN FINL CORP VA
FRO	FRONTLINE LTD
FRP	FAIRPOINT COMMUNICATION
FRPT	FORCE PROTECTION INC
FRT	FEDERAL REALTY INVT
FRX	FOREST LABS INC
FSC	FIFTH STREET FINANCE
FSCI	FISHER COMMUNICATIONS
FSII	FSI INTL INC
FSL	FREESCALE SEMICONDUCTOR
FSLR	FIRST SOLAR INC
FSP	FRANKLIN STREET PPTYS C
FSR	FLAGSTONE REINSURANCE
FSS	FEDERAL SIGNAL CORP
FST	FOREST OIL CORP
FSTR	FOSTER L B CO
FSYS	FUEL SYSTEMS SOLUTIONS
FTEK	FUEL TECH INC
FTI	FMC TECHNOLOGIES INC
FTK	FLOTEK INDS INC DEL
FTNT	FORTINET INC
FTO	FRONTIER OIL CORP
FTR	FRONTIER COMMUNICATIONS
FUBC	1ST UNITED BANCORP INC
FUL	FULLER H B CO
FULT	FULTON FINANCIAL CORP
FUR	WINTHROP REALTY TRUST
FURX	FURIEX PHARMACEUTICALS
FVE	FIVE STAR QUALITY CARE
FWRD	FORWARD AIR CORP
FXCB	FOX CHASE BANCORP
FXCM	FXCM INC
FXEN	FX ENERGY INC
G	GENPACT LTD
GABC	GERMAN AMERICAN BANCORP
GAIN	GLADSTONE INVESTMENT
GAS	NICOR INC
GB	GREATBATCH INC
GBCI	GLACIER BANCORP INC
GBDC	GOLUB CAP BDC INC
GBL	GAMCO INVESTORS INC
GBLI	GLOBAL INDEMNITY PLC
GBX	GREENBRIER COMPANIES IN
GCA	GLOBAL CASH ACCESS INC
GCAP	GAIN CAPITAL HLDNGS INC
GCI	GANNETT INC
GCO	GENESCO INC
GCOM	GLOBECOMM SYSTEMS INC
GD	GENERAL DYNAMICS CORP
GDI	GARDNER DENVER INC
GDOT	GREEN DOT CORP
GDP	GOODRICH PETROLEUM CORP
GE	GENERAL ELECTRIC CO
GEF	GREIF INC
GEN	GENON ENERGY INC
GEO	GEO GROUP INC
GEOI	GEORESOURCES INC
GEOY	GEOEYE INC
GERN	GERON CORP
GES	GUESS INC
GET	GAYLORD ENTMT CO
GEVO	GEVO INC
GFF	GRIFFON CORP
GFIG	GFI GROUP INC
GGC	GEORGIA GULF CORP
GGG	GRACO INC
GGP	GENERAL GROWTH PPTYS IN
GGS	GLOBAL GEOPHYSICAL SVCS
GHDX	GENOMIC HEALTH INC
GHL	GREENHILL & CO INC
GHM	GRAHAM CORP
GIFI	GULF ISLAND FABRICATION
GIII	G-III APPAREL GROUP LTD
GILD	GILEAD SCIENCES INC
GIS	GENERAL MILLS INC
GKNT	GEEKNET INC
GKSR	G&K SERVICES INC
GLAD	GLADSTONE CAPITAL CORP
GLBC	GLOBAL CROSSING LTD
GLBL	GLOBAL INDUSTRIES LTD
GLCH	GLEACHER & COMPANY INC
GLDD	GREAT LAKES DREDGE & DO
GLF	GULFMARK OFFSHORE INC
GLNG	GOLAR LNG LTD BERMUDA
GLPW	GLOBAL POWER EQUIPMENT
GLRE	GREENLIGHT CAPITAL RE L
GLT	GLATFELTER
GLUU	GLU MOBILE INC
GLW	CORNING INC
GM	GENERAL MTRS CO
GMAN	GORDMANS STORES INC
GMCR	GREEN MTN COFFEE ROASTE
GME	GAMESTOP CORP
GMO	GENERAL MOLY INC
GMR	GENERAL MARITIME CORP
GMT	GATX CORP
GMXR	GMX RESOURCES INC
GNC	GNC HLDGS INC
GNCMA	GENERAL COMMUNICATION
GNET	GLOBAL TRAFFIC NETWORK
GNK	GENCO SHIPPING & TRADIN
GNOM	COMPLETE GENOMICS INC
GNRC	GENERAC HOLDINGS INC
GNTX	GENTEX CORP
GNW	GENWORTH FINANCIAL INC
GOK	GEOKINETICS INC
GOOD	GLADSTONE COMMERCIAL
GOOG	GOOGLE INC
GORO	GOLD RESOURCE CORP
GOV	GOVERNMENT PPTY INCOME
GPC	GENUINE PARTS CO
GPI	GROUP 1 AUTOMOTIVE INC
GPK	GRAPHIC PACKAGING HLDG
GPN	GLOBAL PAYMENTS INC
GPOR	GULFPORT ENERGY CORP
GPRE	GREEN PLAINS RENEWABLE
GPRO	GEN-PROBE INC
GPS	GAP INC
GPX	GP STRATEGIES CORP
GR	GOODRICH CORP
GRA	GRACE W R & CO
GRB	GERBER SCIENTIFIC INC
GRC	GORMAN RUPP CO
GRIF	GRIFFIN LAND & NURSERIE
GRM	GRAHAM PACKAGING CO INC
GRMN	GARMIN LTD
GRT	GLIMCHER REALTY TRUST
GS	GOLDMAN SACHS GROUP INC
GSAT	GLOBALSTAR INC
GSBC	GREAT SOUTHERN BANCORP
GSIG	GSI GROUP INC CDA NEW
GSIT	GSI TECHNOLOGY
GSM	GLOBE SPECIALTY METALS
GSOL	GLOBAL SOURCES LTD
GSS	GOLDEN STAR RES LTD CDA
GST	GASTAR EXPL LTD
GT	GOODYEAR TIRE & RUBBER
GTI	GRAFTECH INTL LTD
GTIV	GENTIVA HEALTH SERVICES
GTLS	CHART INDUSTRIES INC
GTN	GRAY TELEVISION INC
GTS	TRIPLE-S MANAGEMENT COR
GTXI	GTX INC
GTY	GETTY REALTY CORP
GUID	GUIDANCE SOFTWARE INC
GVA	GRANITE CONSTR INC
GWR	GENESEE & WYOMING INC
GWW	GRAINGER W W INC
GXP	GREAT PLAINS ENERGY INC
GY	GENCORP INC
H	HYATT HOTELS CORP
HA	HAWAIIAN HOLDINGS INC
HAE	HAEMONETICS CORP
HAFC	HANMI FINANCIAL CORP
HAIN	HAIN CELESTIAL GROUP
HAL	HALLIBURTON CO
HALL	HALLMARK FINL SVCS INC
HALO	HALOZYME THERAPEUTICS
HANS	HANSEN NAT CORP
HAR	HARMAN INTERNATIONAL IN
HAS	HASBRO INC
HAYN	HAYNES INTERNATIONAL IN
HBAN	HUNTINGTON BANCSHARES
HBHC	HANCOCK HOLDING CO
HBI	HANESBRAND INC
HBIO	HARVARD BIOSCIENCE INC
HCA	HCA HOLDINGS INC
HCBK	HUDSON CITY BANCORP
HCC	HCC INSURANCE HLDGS IN
HCCI	HERITAGE CRYL CLEAN INC
HCKT	HACKETT GROUP INC
HCN	HEALTH CARE REIT INC
HCP	HCP INC
HCSG	HEALTHCARE SVCS GRP INC
HD	HOME DEPOT INC
HDY	HYPERDYNAMICS CORP
HE	HAWAIIAN ELECTRIC INDS
HEES	H&E EQUIPMENT SERVICES
HEI	HEICO CORP
HEK	HECKMANN CORP
HELE	HELEN OF TROY LTD
HERO	HERCULES OFFSHORE INC
HES	HESS CORP
HEV	ENER1 INC
HF	HFF INC
HFWA	HERITAGE FINANCIAL CORP
HGG	HHGREGG INC
HGIC	HARLEYSVILLE GROUP INC
HGR	HANGER ORTHOPEDIC GROUP
HGSI	HUMAN GENOME SCIENCES
HHC	HOWARD HUGHES CORP
HHGP	HUDSON HIGHLAND GROUP
HHS	HARTE HANKS INC
HI	HILLENBRAND INC
HIBB	HIBBETT SPORTS INC
HIG	HARTFORD FINL SVCS GRP
HII	HUNTINGTON INGALLS IND
HIL	HILL INTERNATIONAL INC
HILL	DOT HILL SYS CORP
HITK	HI-TECH PHARMACAL CO IN
HITT	HITTITE MICROWAVE CORP
HIW	HIGHWOODS PROPERTIES IN
HK	PETROHAWK ENERGY CORP
HL	HECLA MINING CO
HLF	HERBALIFE LTD
HLIT	HARMONIC INC
HLS	HEALTHSOUTH CORP
HLX	HELIX ENERGY SOLUTIONS
HMA	HEALTH MGMT ASSOC INC
HME	HOME PROPERTIES INC
HMN	HORACE MANN EDUCATORS
HMPR	HAMPTON ROADS BANKSHARE
HMSY	HMS HOLDINGS CORP
HNH	HANDY & HARMAN HLDGS LT
HNI	HNI CORPORATION
HNR	HARVEST NATURAL RES
HNRG	HALLADOR ENERGY CO
HNSN	HANSEN MEDICAL INC
HNT	HEALTH NET INC
HNZ	HEINZ H J CO
HOC	HOLLY CORP
HOG	HARLEY DAVIDSON INC
HOLX	HOLOGIC INC
HOMB	HOME BANCSHARES INC
HOME	HOME FEDERAL BANCORP
HON	HONEYWELL INTERNATIONAL
HOOK	CRAFT BREWERS ALLIANCE
HOS	HORNBECK OFFSHORE SVCS
HOT	STARWOOD HOTELS & RESRT
HOTT	HOT TOPIC INC
HOV	HOVNANIAN ENTERPRISES
HP	HELMERICH & PAYNE INC
HPP	HUDSON PAC PPTYS INC
HPQ	HEWLETT PACKARD CO
HPT	HOSPITALITY PPTYS TRUST
HPY	HEARTLAND PAYMENT SYS
HR	HEALTHCARE REALTY TRUST
HRB	BLOCK H & R INC
HRC	HILL-ROM HOLDINGS INC
HRG	HARBINGER GROUP INC
HRL	HORMEL FOODS CORP
HRS	HARRIS CORP
HS	HEALTHSPRING INC
HSC	HARSCO CORP
HSIC	SCHEIN HENRY INC
HSII	HEIDRICK & STRUGGLES
HSNI	HSN INC
HSP	HOSPIRA INC
HST	HOST HOTELS & RESORTS
HSTM	HEALTHSTREAM INC
HSY	HERSHEY COMPANY
HT	HERSHA HOSPITALITY TRUS
HTBK	HERITAGE COMMERCE CORP
HTCO	HICKORY TECH CORP
HTGC	HERCULES TECHNOLOGY GR
HTH	HILLTOP HOLDINGS INC
HTLD	HEARTLAND EXPRESS INC
HTLF	HEARTLAND FINANCIAL USA
HTS	HATTERAS FINL CORP
HTWR	HEARTWARE INTL INC
HTZ	HERTZ GLOBAL HOLDINGS
HUB.B	HUBBELL INC
HUBG	HUB GROUP INC
HUM	HUMANA INC
HUN	HUNTSMAN CORP
HURC	HURCO COMPANIES INC
HURN	HURON CONSULTING GROUP
HUSA	HOUSTON AMERICAN ENERGY
HUVL	HUDSON VALLEY HOLDING
HVT	HAVERTY FURNITURE INC
HW	HEADWATERS INC
HWAY	HEALTHWAYS INC
HWCC	HOUSTON WIRE & CABLE
HWKN	HAWKINS INC
HXL	HEXCEL CORP
HYC	HYPERCOM CORP
HZO	MARINEMAX INC
IACI	IAC INTERACTIVECORP
IART	INTEGRA LIFESCIENCES
IBI	INTERLINE BRANDS INC
IBKC	IBERIABANK CORP
IBKR	INTERACTIVE BROKERS GRO
IBM	INTL BUSINESS MACHINES
IBOC	INTERNATIONAL BANCSHARE
ICE	INTERCONTINENTALEXCHANG
ICFI	ICF INTERNATIONAL INC
ICGE	ICG GROUP INC
ICLK	INTERCLICK INC
ICOG	ICO GLOBAL COMM HLDGS
ICON	ICONIX BRAND GROUP INC
ICUI	ICU MEDICAL INC
ID	L-1 IDENTITY SOLUTIONS
IDA	IDACORP INC
IDCC	INTERDIGITAL INC
IDIX	IDENIX PHARMACEUTICALS
IDT	IDT CORP
IDTI	INTEGRATED DEVICE TECH
IDXX	IDEXX LABS INC
IEX	IDEX CORP
IFF	INTL FLAVORS & FRAGRANC
IFSIA	INTERFACE INC
IFT	IMPERIAL HOLDINGS INC
IGT	INTL GAME TECHNOLOGY
IGTE	IGATE CORP
IHC	INDEPENDENCE HOLDING CO
IHS	IHS INC
IIIN	INSTEEL INDUSTRIES INC
IILG	INTERVAL LEISURE GRP IN
IIVI	II VI INC
IL	INTRALINKS HLDGS INC
ILMN	ILLUMINA INC
IM	INGRAM MICRO INC
IMGN	IMMUNOGEN INC
IMKTA	INGLES MARKETS INC
IMMR	IMMERSION CORP
IMMU	IMMUNOMEDICS INC
IMN	IMATION CORP
IN	INTERMEC INC
INAP	INTERNAP NETWORK SVCS C
INCY	INCYTE CORP
INDB	INDEPENDENT BANK MA
INFA	INFORMATICA CORP
INFI	INFINITY PHARMACEUTICAL
INFN	INFINERA CORP
INHX	INHIBITEX INC
ININ	INTERACTIVE INTELLIGENC
INN	SUMMIT HOTEL PROPER
INSM	INSMED INC
INSP	INFOSPACE INC
INSU	INSITUFORM TECHNOLOGIES
INT	WORLD FUEL SVCS CORP
INTC	INTEL CORP
INTL	INTL FCSTONE INC
INTU	INTUIT
INTX	INTERSECTIONS INC
INVE	IDENTIVE GROUP INC
INWK	INNERWORKINGS INC
IO	ION GEOPHYSICAL CORP
IOSP	INNOSPEC INC
IP	INTERNATIONAL PAPER CO
IPAR	INTER PARFUMS INC
IPCC	INFINITY PPTY & CAS COR
IPCM	IPC THE HOSPITALIST CO
IPG	INTERPUBLIC GROUP OF CO
IPGP	IPG PHOTONICS CORP
IPHI	INPHI CORP
IPHS	INNOPHOS HOLDINGS INC
IPI	INTREPID POTASH INC
IPSU	IMPERIAL SUGAR CO
IPXL	IMPAX LABORATORIES INC
IR	INGERSOLL-RAND PLC
IRBT	IROBOT CORP
IRC	INLAND REAL ESTATE CORP
IRDM	IRIDIUM COMMUNICATIONS
IRET	INVESTORS REAL ESTATE T
IRF	INTERNATIONAL RECTIFIER
IRIS	IRIS INTERNATIONAL INC
IRM	IRON MOUNTAIN INC
IRWD	IRONWOOD PHARMACEUTICAL
ISBC	INVESTORS BANCORP INC
ISCA	INTERNATIONAL SPEEDWAY
ISH	INTL SHIPHOLDING CORP
ISIL	INTERSIL CORP
ISIS	ISIS PHARMACEUTICALS
ISLE	ISLE OF CAPRI CASINOS
ISRG	INTUITIVE SURGICAL INC
ISRL	ISRAMCO INC
ISSI	INTEGRATED SILICON S
ISTA	ISTA PHARMACEUTICALS IN
ISYS	INTEGRAL SYSTEMS INC
IT	GARTNER INC
ITC	ITC HOLDINGS CORP
ITG	INVESTMENT TECHNOLOGY
ITMN	INTERMUNE INC
ITRI	ITRON INC
ITT	ITT CORPORATION
ITW	ILLINOIS TOOL WORKS INC
IVAC	INTEVAC INC
IVC	INVACARE CORP
IVR	INVESCO MORTGAGE CAP
IVZ	INVESCO LTD
IXYS	IXYS CORP
JACK	JACK IN THE BOX INC
JAG	JAGUAR MNG INC
JAH	JARDEN CORP
JAKK	JAKKS PACIFIC INC
JAZZ	JAZZ PHARMACEUTICALS IN
JBHT	HUNT J B TRANS SVCS
JBL	JABIL CIRCUIT INC
JBLU	JETBLUE AIRWAYS CORP
JBT	JOHN BEAN TECH CORP
JCI	JOHNSON CONTROLS INC
JCOM	J2 GLOBAL COMMUNICATION
JCP	PENNEY J C INC
JCS	COMMUNICATIONS SYSTEMS
JDAS	JDA SOFTWARE GROUP INC
JDSU	JDS UNIPHASE CORP
JEC	JACOBS ENGINEERING GRP
JEF	JEFFERIES GROUP INC
JJSF	J & J SNACK FOODS CO
JKHY	HENRY JACK & ASSOCIATES
JLL	JONES LANG LASALLE INC
JMBA	JAMBA INC
JMP	JMP GROUP INC
JNJ	JOHNSON & JOHNSON
JNPR	JUNIPER NETWORKS INC
JNS	JANUS CAPITAL GROUP INC
JNY	THE JONES GROUP INC
JOE	ST JOE CO
JOSB	JOS A BANK CLOTHIERS IN
JOUT	JOHNSON OUTDOORS INC
JOYG	JOY GLOBAL INC
JPM	JPMORGAN CHASE & CO
JRCC	JAMES RIVER COAL CO
JRN	JOURNAL COMMUNICATIONS
JW.A	WILEY JOHN & SONS INC
JWN	NORDSTROM INC
K	KELLOGG CO
KAI	KADANT INC
KALU	KAISER ALUMINUM CORP
KAMN	KAMAN CORP
KAR	KAR AUCTION SERVICES IN
KBALB	KIMBALL INTERNATIONAL
KBH	KB HOME
KBR	KBR INC
KBW	KBW INC
KCAP	KOHLBERG CAPITAL CORP
KCG	KNIGHT CAPITAL GROUP IN
KCI	KINETIC CONCEPTS INC
KCLI	KANSAS CITY LIFE INS CO
KCP	COLE KENNETH PRODTNS
KDN	KAYDON CORP
KEG	KEY ENERGY SERVICES INC
KELYA	KELLY SERVICES INC
KEM	KEMET CORP
KERX	KERYX BIOPHARMACEUTICAL
KEX	KIRBY CORP
KEY	KEYCORP
KEYN	KEYNOTE SYSTEMS INC
KEYW	KEYW HOLDING CORP
KFRC	KFORCE INC
KFT	KRAFT FOODS INC
KFY	KORN FERRY INTERNATIONA
KIM	KIMCO REALTY CORP
KIRK	KIRKLANDS INC
KITD	KIT DIGITAL INC
KKD	KRISPY KREME DOUGHNUTS
KLAC	KLA-TENCOR CORP
KLIC	KULICKE & SOFFA INDS
KMB	KIMBERLY CLARK CORP
KMGB	KMG CHEMICALS INC
KMI	KINDER MORGAN INC DEL
KMT	KENNAMETAL INC
KMX	CARMAX INC
KND	KINDRED HEALTHCARE INC
KNDL	KENDLE INTERNATIONAL IN
KNL	KNOLL INC
KNOL	KNOLOGY INC
KNOT	KNOT INC
KNSY	KENSEY NASH CORP
KNX	KNIGHT TRANSPORTATION
KNXA	KENEXA CORP
KO	COCA COLA CO
KOG	KODIAK OIL & GAS CORP
KOP	KOPPERS HOLDINGS INC
KOPN	KOPIN CORP
KOS	KOSMOS ENERGY LTD
KR	KROGER CO
KRA	KRATON PERF POLYMERS
KRC	KILROY REALTY CORP
KRG	KITE REALTY GROUP TRUST
KRNY	KEARNY FINANCIAL CORP
KRO	KRONOS WORLDWIDE INC
KS	KAPSTONE PAPER & PACKAG
KSS	KOHLS CORP
KSU	KANSAS CITY SOUTHERN
KSWS	K-SWISS INC
KTOS	KRATOS DEFENSE & SEC SO
KV.A	K V PHARMACEUTICAL CO
KVHI	KVH INDUSTRIES INC
KW	KENNEDY-WILSON HLDGS IN
KWK	QUICKSILVER RESOURCES
KWR	QUAKER CHEMICAL CORP
L	LOEWS CORP
LABL	MULTI COLOR CORP
LAD	LITHIA MOTORS INC
LAMR	LAMAR ADVERTISING CO
LANC	LANCASTER COLONY CORP
LAVA	MAGMA DESIGN AUTOMATION
LAWS	LAWSON PRODUCTS INC
LAYN	LAYNE CHRISTENSEN CO
LAZ	LAZARD LTD
LB	LABARGE INC
LBAI	LAKELAND BANCORP INC
LBTYA	LIBERTY GLOBAL INC
LBY	LIBBEY INC
LCAPA	LIBERTY CAPITAL
LCC	U S AIRWAYS GROUP INC
LCI	LANNETT CO INC
LCRY	LECROY CORP
LCUT	LIFETIME BRANDS INC
LDL	LYDALL INC
LDR	LANDAUER INC
LEA	LEAR CORP
LEAP	LEAP WIRELESS INTL INC
LECO	LINCOLN ELECTRIC HLDGS
LEG	LEGGETT & PLATT INC
LEN	LENNAR CORP
LF	LEAPFROG ENTERPRISES IN
LFUS	LITTELFUSE INC
LG	LACLEDE GROUP INC
LGF	LIONS GATE ENTMNT CORP
LGND	LIGAND PHARMACEUTICALS
LH	LABORATORY CORP OF AMER
LHCG	LHC GROUP INC
LHO	LASALLE HOTEL PROPERTIE
LIFE	LIFE TECHNOLOGIES CORP
LII	LENNOX INTERNATIONAL IN
LINC	LINCOLN EDUCATIONAL SVS
LINTA	LIBERTY INTERACTIVE
LIOX	LIONBRIDGE TECHNOLOGIES
LIZ	LIZ CLAIBORNE INC
LKFN	LAKELAND FINANCIAL CORP
LKQX	LKQ CORP
LL	LUMBER LIQUIDATORS HLDG
LLEN	L & L ENERGY INC
LLL	L-3 COMMUNICATIONS HLDG
LLNW	LIMELIGHT NETWORKS INC
LLTC	LINEAR TECHNOLOGY CO
LLY	LILLY ELI & CO
LM	LEGG MASON INC
LMIA	LMI AEROSPACE INC
LMNR	LIMONEIRA CO
LMNX	LUMINEX CORP
LMT	LOCKHEED MARTIN CORP
LNC	LINCOLN NATIONAL CORP
LNCE	SNYDER'S-LANCE INC
LNCR	LINCARE HOLDINGS INC
LNDC	LANDEC CORP
LNG	CHENIERE ENERGY INC
LNKD	LINKEDIN CORP
LNN	LINDSAY CORP
LNT	ALLIANT ENERGY CORP
LO	LORILLARD INC
LOGM	LOGMEIN INC
LOOP	LOOPNET INC
LOPE	GRAND CANYON EDUCATION
LORL	LORAL SPACE & COMM
LOW	LOWES COS INC
LPLA	LPL INVT HLDGS INC
LPNT	LIFEPOINT HOSPITALS
LPS	LENDER PROCESSING SVCS
LPSN	LIVEPERSON INC
LPX	LOUISIANA PACIFIC CORP
LQDT	LIQUIDITY SERVICES INC
LRCX	LAM RESEARCH CORP
LRN	K12 INC
LRY	LIBERTY PROPERTY TRUST
LSCC	LATTICE SEMICONDUCTOR
LSE	CAPLEASE INC
LSI	LSI CORPORATION
LSTR	LANDSTAR SYSTEMS INC
LSTZA	LIBERTY STARZ
LTC	LTC PROPERTIES INC
LTD	LIMITED BRANDS INC
LTM	LIFE TIME FITNESS INC
LTS	LADENBURG THALMAN FIN
LTXC	LTX-CREDENCE CORP
LUB	LUBYS INC
LUFK	LUFKIN INDUSTRIES INC
LUK	LEUCADIA NATIONAL CORP
LUV	SOUTHWEST AIRLINES CO
LVB	STEINWAY MUSICAL INS
LVLT	LEVEL 3 COMMUNICATIONS
LVS	LAS VEGAS SANDS CORP
LWAY	LIFEWAY FOODS INC
LWSN	LAWSON SOFTWARE INC
LXK	LEXMARK INTERNATIONAL
LXP	LEXINGTON REALTY TRUST
LXRX	LEXICON PHARMACEUTICALS
LXU	LSB INDUSTRIES INC
LYB	LYONDELLBASELL INDS
LYTS	LSI INDUSTRIES INC
LYV	LIVE NATION ENT INC
LZ	LUBRIZOL CORP
LZB	LA Z BOY INC
M	MACYS INC
MA	MASTERCARD INC
MAA	MID-AMER APT CMNTYS
MAC	MACERICH CO
MAIN	MAIN STREET CAPITAL COR
MAKO	MAKO SURGICAL CORP
MAN	MANPOWERGROUP
MANH	MANHATTAN ASSOCS INC
MANT	MANTECH INTERNATIONAL
MAPP	MAP PHARMACEUTICALS INC
MAR	MARRIOTT INTL INC
MAS	MASCO CORP
MASI	MASIMO CORPORATION
MAT	MATTEL INC
MATW	MATTHEWS INTERNATIONAL
MAXY	MAXYGEN INC
MBFI	MB FINANCIAL INC
MBI	MBIA INC
MBLX	METABOLIX INC
MBVT	MERCHANTS BANCSHARES
MCC	MEDLEY CAPITAL CORP
MCD	MCDONALDS CORP
MCF	CONTANGO OIL & GAS CO
MCGC	MCG CAPITAL CORP
MCHP	MICROCHIP TECHNOLOGY
MCHX	MARCHEX INC
MCK	MCKESSON CORP
MCO	MOODYS CORP
MCP	MOLYCORP INC
MCRI	MONARCH CASINO & RESORT
MCRL	MICREL INC
MCRS	MICROS SYSTEMS INC
MCS	MARCUS CORP
MCY	MERCURY GENERAL CORP
MD	MEDNAX INC
MDAS	MEDASSETS INC
MDC	MDC HOLDINGS INC
MDCA	MDC CORP
MDCI	MEDICAL ACTION INDS INC
MDCO	MEDICINES CO
MDF	METROPOLITAN HEALTH NET
MDMD	MEDIAMIND TECH INC
MDP	MEREDITH CORP
MDR	MCDERMOTT INTL INC
MDRX	ALLSCRIPTS HEALTHCARE
MDSO	MEDIDATA SOLUTIONS INC
MDT	MEDTRONIC INC
MDTH	MEDCATH CORP
MDU	MDU RESOURCES GROUP INC
MDVN	MEDIVATION INC
MDW	MIDWAY GOLD CORP
MEA	METALICO INC
MEAS	MEASUREMENT SPECIALTIES
MED	MEDIFAST INC
MEDH	MEDQUIST HLDGS INC
MEI	METHODE ELECTRS INC
MENT	MENTOR GRAPHICS CORP
MERU	MERU NETWORKS INC
MET	METLIFE INC
METR	METRO BANCORP INC
MF	MF GLOBAL HOLDINGS LTD
MFA	MFA FINANCIAL INC
MFB	MAIDENFORM BRANDS INC
MFLX	MULTI-FINELINE ELECTRON
MFW	M & F WORLDWIDE CORP
MG	MISTRAS GROUP INC
MGAM	MULTIMEDIA GAMES HLD CO
MGEE	MGE ENERGY INC
MGI	MONEYGRAM INTERNATIONAL
MGLN	MAGELLAN HEALTH SVCS IN
MGM	MGM RESORTS INTL
MGPI	MGP INGREDIENTS INC
MGRC	MCGRATH RENTCORP
MHGC	MORGANS HOTEL GROUP CO
MHK	MOHAWK INDUSTRIES INC
MHLD	MAIDEN HOLDINGS LTD
MHO	M/I HOMES INC
MHP	MCGRAW HILL COS INC
MHR	MAGNUM HUNTER RES CORP
MHS	MEDCO HEALTH SOLUTIONS
MI	MARSHALL & ILSLEY CORP
MIDD	MIDDLEBY CORP
MIG	MEADOWBROOK INS GROUP
MILL	MILLER ENERGY RES INC
MIND	MITCHAM INDUSTRIES INC
MINI	MOBILE MINI INC
MIPS	MIPS TECHNOLOGIES INC
MITI	MICROMET INC
MJN	MEAD JOHNSON NUTRITION
MKC	MCCORMICK & CO INC
MKL	MARKEL CORP
MKSI	MKS INSTRUMENTS INC
MKTG	RESPONSYS INC
MKTX	MARKETAXESS HOLDINGS IN
MLHR	HERMAN MILLER INC
MLI	MUELLER INDUSTRIES INC
MLM	MARTIN MARIETTA MTLS
MLNK	MODUSLINK GLB SOLUTIONS
MLR	MILLER INDUSTRIES INC
MMC	MARSH & MCLENNAN COS
MMI	MOTOROLA MOBILITY HLDGS
MMM	3M CO
MMR	MCMORAN EXPLORATION CO
MMS	MAXIMUS INC
MMSI	MERIT MED SYSTEMS INC
MNI	MCCLATCHY CO
MNKD	MANNKIND CORP
MNR	MONMOUTH REAL ESTATE
MNRO	MONRO MUFFLER BRAKE INC
MNTA	MOMENTA PHARMACEUTICALS
MO	ALTRIA GROUP INC
MOD	MODINE MANUFACTURING CO
MOG.A	MOOG INC
MOH	MOLINA HEALTHCARE INC
MOLX	MOLEX INC
MON	MONSANTO CO
MORN	MORNINGSTAR INC
MOS	MOSAIC COMPANY
MOSY	MOSYS INC
MOTR	MOTRICITY INC
MOV	MOVADO GROUP INC
MOVE	MOVE INC
MPAA	MOTORCAR PTS AMERICA IN
MPG	MPG OFFICE TRUST INC
MPR	MET-PRO CORP
MPW	MEDICAL PROPERTIES TRUS
MPWR	MONOLITHIC POWER SYSTEM
MPX	MARINE PRODUCTS CORP
MRCY	MERCURY COMPUTER SYSTEM
MRGE	MERGE HEALTHCARE INC
MRH	MONTPELIER RE HOLDINGS
MRK	MERCK & CO INC
MRLN	MARLIN BUSINESS SVCS
MRO	MARATHON OIL CORP
MRTN	MARTEN TRANS LTD
MRVL	MARVELL TECHNOLOGY GROU
MRX	MEDICIS PHARMACEUTICAL
MS	MORGAN STANLEY
MSA	MINE SAFETY APPLIANCES
MSCC	MICROSEMI CORP
MSCI	MSCI INC
MSEX	MIDDLESEX WATER CO
MSFG	MAINSOURCE FINANCIAL GR
MSFT	MICROSOFT CORP
MSG	MADISON SQUARE GARDEN
MSI	MOTOROLA SOLUTIONS INC
MSL	MIDSOUTH BANCORP INC
MSM	MSC INDL DIRECT INC
MSO	MARTHA STEWART LIVING
MSPD	MINDSPEED TECHNOLOGIES
MSSR	MCCORMICK & SCHMICKS
MSTR	MICROSTRATEGY INC
MSW	MISSION WEST PROPERTIES
MTB	M & T BANK CORP
MTD	METTLER TOLEDO INTL INC
MTG	MGIC INVESTMENT CORP
MTH	MERITAGE HOMES CORP
MTN	VAIL RESORTS INC
MTOR	MERITOR INC
MTOX	MEDTOX SCIENTIFIC INC
MTRN	MATERION CORPORATION
MTRX	MATRIX SERVICE CO
MTSC	MTS SYSTEMS CORP
MTW	MANITOWOC CO INC
MTX	MINERALS TECHNOLOGIES
MTZ	MASTEC INC
MU	MICRON TECHNOLOGY INC
MUR	MURPHY OIL CORP
MUSA	METALS USA HLDGS CORP
MVC	MVC CAPITAL INC
MVIS	MICROVISION INC DEL
MW	MENS WEARHOUSE INC
MWA	MUELLER WTR PRODS INC
MWIV	MWI VETERINARY SUPPLY
MWV	MEADWESTVACO CORP
MWW	MONSTER WORLDWIDE INC
MXIM	MAXIM INTEGRATED PRODS
MXL	MAXLINEAR INC
MXWL	MAXWELL TECHNOLOGIES IN
MYE	MYERS INDUSTRIES INC
MYGN	MYRIAD GENETICS INC
MYL	MYLAN INC
MYRG	MYR GROUP INC DEL
N	NETSUITE INC
NABI	NABI BIOPHARMACEUTICALS
NAFC	NASH FINCH CO
NANO	NANOMETRICS INC
NARA	NARA BANCORP INC
NAT	NORDIC AMERICAN TANKER
NATI	NATIONAL INSTRS CORP
NATL	NATIONAL INTERSTATE COR
NATR	NATURES SUNSHINE PRODS
NAUH	NATIONAL AMERN UNIV
NAV	NAVISTAR INTL CORP NEW
NAVG	NAVIGATORS GROUP INC
NBIX	NEUROCRINE BIOSCIENCES
NBL	NOBLE ENERGY INC
NBR	NABORS INDUSTRIES LTD
NBS	NEOSTEM INC
NBTB	NBT BANCORP INC
NC	NACCO INDUSTRIES INC
NCI	NAVIGANT CONSULTING INC
NCIT	NCI INC
NCMI	NATIONAL CINEMEDIA INC
NCR	NCR CORP
NCS	NCI BUILDING SYSTEMS IN
NCT	NEWCASTLE INVT CORP
NDAQ	NASDAQ OMX GROUP INC
NDN	99 CENTS ONLY STORES
NDSN	NORDSON CORP
NEE	NEXTERA ENERGY INC
NEM	NEWMONT MINING CORP
NEOG	NEOGEN CORP
NEOP	NEOPROBE CORP
NETL	NETLOGIC MICROSYSTEMS
NEU	NEWMARKET CORPORATION
NEWP	NEWPORT CORP
NEWS	NEWSTAR FINANCIAL INC
NFBK	NORTHFIELD BANCORP INC
NFG	NATIONAL FUEL GAS CO
NFLX	NETFLIX INC
NFP	NATIONAL FINL PARTNERS
NFX	NEWFIELD EXPLORATION CO
NGPC	NGP CAPITAL RESOURCES
NGS	NATURAL GAS SERVICES GR
NHC	NATIONAL HEALTHCARE COR
NHI	NATIONAL HEALTH INVS IN
NHP	NATIONWIDE HEALTH PPTYS
NI	NISOURCE INC
NICK	NICHOLAS FINANCIAL INC
NIHD	NII HOLDINGS INC
NILE	BLUE NILE INC
NJR	NEW JERSEY RESOURCES
NKE	NIKE INC
NKSH	NATIONAL BANKSHARES INC
NKTR	NEKTAR THERAPEUTICS
NL	NL INDUSTRIES INC
NLC	NALCO HOLDING COMPANY
NLSN	NIELSEN HOLDINGS NV
NLY	ANNALY CAPITAL MGMT INC
NMFC	NEW MTN FIN CORP
NMRX	NUMEREX CORP
NNBR	NN INC
NNI	NELNET INC
NNN	NATIONAL RETAIL PPTYS
NOC	NORTHROP GRUMMAN CORP
NOG	NORTHERN OIL & GAS INC
NOR	NORANDA ALUM HLDG CORP
NOV	NATIONAL OILWELL VARCO
NP	NEENAH PAPER INC
NPBC	NATIONAL PENN BANCSHARE
NPK	NATIONAL PRESTO INDS IN
NPO	ENPRO INDUSTRIES INC
NPSP	NPS PHARMACEUTICALS INC
NPTN	NEOPHOTONICS CORP
NR	NEWPARK RESOURCES INC
NRCI	NATIONAL RESEARCH CORP
NRF	NORTHSTAR REALTY FINANC
NRG	NRG ENERGY INC
NSC	NORFOLK SOUTHERN CORP
NSIT	INSIGHT ENTERPRISES INC
NSM	NATIONAL SEMICONDUCTOR
NSP	INSPERITY INC
NSR	NEUSTAR INC
NST	NSTAR
NSTC	NESS TECHNOLOGIES INC
NTAP	NETAPP INC
NTCT	NETSCOUT SYSTEMS INC
NTGR	NETGEAR INC
NTLS	NTELOS HOLDINGS CORP
NTRI	NUTRI SYSTEM INC
NTRS	NORTHERN TRUST CORP
NTSP	NETSPEND HOLDINGS INC
NU	NORTHEAST UTILITIES
NUAN	NUANCE COMMUNICATIONS
NUE	NUCOR CORP
NUS	NU SKIN ENTERPRISES
NUTR	NUTRACEUTICAL INTL CORP
NUVA	NUVASIVE INC
NVAX	NOVAVAX INC
NVDA	NVIDIA CORP
NVE	NV ENERGY INC
NVEC	NVE CORP
NVLS	NOVELLUS SYSTEMS INC
NVR	NVR INC
NVTL	NOVATEL WIRELESS INC
NWBI	NORTHWEST BANCSHARES IN
NWE	NORTHWESTERN CORP
NWL	NEWELL RUBBERMAID INC
NWLI	NATIONAL WESTRN LIFE IN
NWN	NORTHWEST NATURAL GAS C
NWPX	NORTHWEST PIPE CO
NWSA	NEWS CORP
NWY	NEW YORK & CO INC
NX	QUANEX BUILDING PRODUCT
NXST	NEXSTAR BROADCASTING GR
NXTM	NXSTAGE MEDICAL INC
NYB	NEW YORK CMNTY BANCORP
NYMX	NYMOX PHARMACEUTICAL
NYT	NEW YORK TIMES CO
NYX	NYSE EURONEXT
O	REALTY INCOME CORP
OABC	OMNIAMERICAN BANCORP IN
OAS	OASIS PETE INC
OB	ONEBEACON INSURANCE GRP
OC	OWENS CORNING NEW
OCFC	OCEANFIRST FINANCIAL
OCLR	OCLARO INC
OCN	OCWEN FINANCIAL CORP
OCR	OMNICARE INC
OCZ	OCZ TECHNOLOGY GROUP IN
ODC	OIL DRI CORP OF AMERICA
ODFL	OLD DOMINION FREIGHT
ODP	OFFICE DEPOT INC
OEH	ORIENT-EXPRESS HOTELS
OFC	CORPORATE OFFICE PPTYS
OFG	ORIENTAL FINANCIAL GROU
OFIX	ORTHOFIX INTL N V
OFLX	OMEGA FLEX INC
OGE	OGE ENERGY CORP
OGXI	ONCOGENEX PHARMAS INC
OHI	OMEGA HEALTHCARE INVS
OI	OWENS ILLINOIS INC
OII	OCEANEERING INTL INC
OIS	OIL STATES INTERNATIONA
OKE	ONEOK INC
OKSB	SOUTHWEST BANCORP INC O
OLN	OLIN CORP
OLP	ONE LIBERTY PROPERTIES
OMC	OMNICOM GROUP INC
OMCL	OMNICELL INC
OME	OMEGA PROTEIN CORP
OMEX	ODYSSEY MARINE EXPLOR
OMG	OM GROUP INC
OMI	OWENS & MINOR INC
OMN	OMNOVA SOLUTIONS INC
OMPI	OBAGI MEDICAL PROD INC
OMX	OFFICEMAX INC
ONB	OLD NATIONAL BANCORP
ONE	HIGHER ONE HLDGS INC
ONNN	ON SEMICONDUCTOR CORP
ONTY	ONCOTHYREON INC
ONXX	ONYX PHARMACEUTICALS IN
OPEN	OPENTABLE INC
OPK	OPKO HEALTH INC
OPLK	OPLINK COMMUNICATIONS
OPNT	OPNET TECHNOLOGIES INC
OPTR	OPTIMER PHARMA INC
OPWV	OPENWAVE SYSTEMS INC
OPXT	OPNEXT INC
OPY	OPPENHEIMER HOLDINGS IN
ORA	ORMAT TECHNOLOGIES INC
ORB	ORBITAL SCIENCES CORP
ORBC	ORBCOMM INC
ORCL	ORACLE CORP
OREX	OREXIGEN THERAPEUTICS
ORI	OLD REPUBLIC INTL CORP
ORIT	ORITANI FINANCIAL CORP
ORLY	O REILLY AUTOMOTIVE INC
ORN	ORION MARINE GROUP INC
ORRF	ORRSTOWN FINL SVCS INC
OSG	OVERSEAS SHIPHOLDNG GRP
OSIR	OSIRIS THERAPEUTICS
OSIS	OSI SYSTEMS INC
OSK	OSHKOSH CORP
OSTK	OVERSTOCK COM INC
OSUR	ORASURE TECHNOLOGIES IN
OTTR	OTTER TAIL CORP
OUTD	OUTDOOR CHANNEL HLDGS
OVTI	OMNIVISION TECHNOLOGIES
OWW	ORBITZ WORLDWIDE INC
OXM	OXFORD INDUSTRIES INC
OXPS	OPTIONSXPRESS HOLDINGS
OXY	OCCIDENTAL PETE CORP
OYOG	OYO GEOSPACE CORP
OZRK	BANK OF THE OZARKS INC
PACB	PACIFIC BIOSCIENCES CA
PACR	PACER INTERNATIONAL INC
PACW	PACWEST BANCORP
PAET	PAETEC HOLDING CORP
PAG	PENSKE AUTOMOTIVE GROUP
PANL	UNIVERSAL DISPLAY CORP
PATR	PATRIOT TRANSPORTATION
PAY	VERIFONE SYSTEMS INC
PAYX	PAYCHEX INC
PBCT	PEOPLES UNITED FINANCIA
PBH	PRESTIGE BRANDS HOLDING
PBI	PITNEY BOWES INC
PBNY	PROVIDENT NY BANCORP
PBY	PEP BOYS MANNY MOE&J
PCAR	PACCAR INC
PCBC	PACIFIC CAPITAL BANCORP
PCBK	PACIFIC CONTINENTAL COR
PCCC	P C CONNECTION
PCG	PG&E CORP
PCH	POTLATCH CORP
PCL	PLUM CREEK TIMBER CO IN
PCLN	PRICELINE COM INC
PCP	PRECISION CASTPARTS
PCRX	PACIRA PHARMACEUTICALS
PCS	METROPCS COMMUNICATIONS
PCX	PATRIOT COAL CORP
PCYC	PHARMACYCLICS INC
PDC	PIONEER DRILLING CO
PDCO	PATTERSON COS INC
PDFS	PDF SOLUTIONS INC
PDLI	PDL BIOPHARMA INC
PDM	PIEDMONT OFFICE RLTY TR
PEB	PEBBLEBROOK HOTEL TRUST
PEBO	PEOPLES BANCORP INC
PEET	PEETS COFFEE & TEA INC
PEG	PUBLIC SVC ENTERPRISE
PEGA	PEGASYSTEMS INC
PEI	PENNSYLVANIA REAL ESTAT
PENN	PENN NATIONAL GAMING IN
PEP	PEPSICO INC
PERY	ELLIS PERRY INTL INC
PETD	PETROLEUM DEV CORP
PETM	PETSMART INC
PETS	PETMED EXPRESS INC
PFCB	P F CHANGS CHINA BISTRO
PFE	PFIZER INC
PFG	PRINCIPAL FINANCIAL GRP
PFS	PROVIDENT FINANCIAL SVC
PG	PROCTER & GAMBLE CO
PGI	PREMIERE GLOBAL SERVICE
PGN	PROGRESS ENERGY INC
PGNX	PROGENICS PHARMACEUTICA
PGR	PROGRESSIVE CORP
PH	PARKER HANNIFIN CORP
PHH	PHH CORPORATION
PHIIK	PHI INC
PHM	PULTEGROUP INC
PHX	PANHANDLE OIL AND GAS
PICO	PICO HOLDINGS INC
PII	POLARIS INDUSTRIES INC
PIKE	PIKE ELECTRIC CORP
PIP	PHARMATHENE INC
PIR	PIER 1 IMPORTS INC
PJC	PIPER JAFFRAY COMPANIES
PKD	PARKER DRILLING CO
PKE	PARK ELECTROCHEMICAL
PKG	PACKAGING CORP OF AMER
PKI	PERKINELMER INC
PKOH	PARK OHIO HOLDINGS CORP
PKT	PROCERA NETWORKS INC
PKY	PARKWAY PROPERTIES INC
PL	PROTECTIVE LIFE CORP
PLAB	PHOTRONICS INC
PLCE	CHILDRENS PLACE RETAIL
PLCM	POLYCOM INC
PLD	PROLOGIS INC
PLFE	PRESIDENTIAL LIFE CORP
PLL	PALL CORP
PLOW	DOUGLAS DYNAMICS INC
PLPC	PREFORMED LINE PRODUCTS
PLT	PLANTRONICS INC
PLUS	EPLUS INC
PLXS	PLEXUS CORP
PLXT	PLX TECHNOLOGY INC
PM	PHILIP MORRIS INTL
PMC	PHARMERICA CORP
PMCS	PMC-SIERRA INC
PMFG	PMFG INC
PMI	PMI GROUP INC
PMT	PENNYMAC MORTGAGE INV
PMTC	PARAMETRIC TECHNOLOGY
PMTI	PALOMAR MEDICAL TECH
PNC	PNC FINANCIAL SVCS GROU
PNFP	PINNACLE FINANCIAL
PNK	PINNACLE ENTMT INC
PNM	PNM RESOURCES INC
PNNT	PENNANTPARK INVT CORP
PNNW	PENNICHUCK CORP
PNR	PENTAIR INC
PNRA	PANERA BREAD CO
PNW	PINNACLE WEST CAPITAL C
PNX	PHOENIX COMPANIES INC
PNY	PIEDMONT NAT GAS INC
PODD	INSULET CORP
POL	POLYONE CORP
POM	PEPCO HOLDINGS INC
POOL	POOL CORP
POR	PORTLAND GEN ELEC CO
POWI	POWER INTEGRATIONS INC
POWL	POWELL INDUSTRIES INC
POWR	POWERSECURE INTL INC
POZN	POZEN INC
PPC	PILGRIMS PRIDE CORP NEW
PPD	PRE PAID LEGAL SERVICES
PPDI	PHARMACEUTICAL PROD
PPG	PPG INDUSTRIES INC
PPHM	PEREGRINE PHARMA INC
PPL	PPL CORP
PPO	POLYPORE INTL INC
PPS	POST PROPERTIES INC
PQ	PETROQUEST ENERGY INC
PRA	PROASSURANCE CORP
PRAA	PORTFOLIO RECOVERY ASSO
PRE	PARTNERRE LTD
PRFT	PERFICIENT INC
PRGO	PERRIGO CO
PRGS	PROGRESS SOFTWARE CORP
PRGX	PRGX GLOBAL INC
PRI	PRIMERICA INC
PRIM	PRIMORIS SVCS CORP
PRK	PARK NATIONAL CORP
PRM	PRIMEDIA INC
PRMW	PRIMO WATER CORP
PRO	PROS HOLDINGS INC
PROJ	DELTEK INC
PRS	PRIMUS GUARANTY LTD
PRSC	PROVIDENCE SERVICE CORP
PRSP	PROSPERITY BANCSHARES
PRTS	US AUTO PARTS NETWRK IN
PRU	PRUDENTIAL FINANCIAL IN
PRX	PAR PHARMACEUTICAL COS
PRXL	PAREXEL INTERNATIONAL
PSA	PUBLIC STORAGE INC
PSB	PS BUSINESS PARKS INC
PSEC	PROSPECT CAPITAL CORP
PSEM	PERICOM SEMICONDUCTOR
PSMT	PRICESMART INC
PSS	COLLECTIVE BRANDS INC
PSSI	PSS WORLD MEDICAL INC
PSTB	PARK STERLING CORP
PSUN	PACIFIC SUNWEAR OF CALI
PTEN	PATTERSON UTI ENERGY
PTIE	PAIN THERAPEUTICS IN
PTP	PLATINUM UNDERWRITER HL
PTRY	PANTRY INC
PTX	PERNIX THERAPEUTICS HLD
PULS	PULSE ELECTRONICS CORP
PVA	PENN VIRGINIA CORP
PVH	PHILLIPS VAN HEUSEN
PVTB	PRIVATEBANCORP INC
PWAV	POWERWAVE TECHNOLOGIES
PWER	POWER-ONE INC
PWOD	PENNS WOODS BANCORP INC
PWR	QUANTA SERVICES INC
PX	PRAXAIR INC
PXD	PIONEER NAT RESOURCES C
PXP	PLAINS EXPLORATION & PR
PZG	PARAMOUNT GOLD & SILVER
PZN	PZENA INVESTMENT MGMT
PZZA	PAPA JOHNS INTERNATIONA
QADA	QAD INC
QCOM	QUALCOMM INC
QCOR	QUESTCOR PHARM INC
QDEL	QUIDEL CORP
QEP	QEP RESOURCES INC
QGEN	QIAGEN NV
QLGC	QLOGIC CORP
QLIK	QLIK TECHNOLOGIES INC
QLTY	QUALITY DISTRIBUTION IN
QNST	QUINSTREET INC
QPSA	QUEPASA CORP
QSFT	QUEST SOFTWARE INC
QSII	QUALITY SYSTEMS INC
QTM	QUANTUM CORP
QUAD	QUAD / GRAPHICS INC
R	RYDER SYSTEM INC
RA	RAILAMERICA INC
RAD	RITE AID CORP
RADS	RADIANT SYSTEMS INC
RAH	RALCORP HOLDINGS INC
RAI	REYNOLDS AMERICAN INC
RAIL	FREIGHTCAR AMERICA INC
RAS	RAIT FINANCIAL TRUST
RAVN	RAVEN INDUSTRIES INC
RAX	RACKSPACE HOSTING INC
RBC	REGAL BELOIT CORP
RBCAA	REPUBLIC BANCORP INC KY
RBCN	RUBICON TECHNOLOGY INC
RBN	ROBBINS & MYERS INC
RCII	RENT A CENTER INC
RCKB	ROCKVILLE FINL INC
RCL	ROYAL CARIBBEAN CRUISES
RDC	ROWAN COMPANIES INC
RDEA	ARDEA BIOSCIENCES INC
RDEN	ELIZABETH ARDEN INC
RDK	RUDDICK CORP
RDN	RADIAN GROUP INC
RDNT	RADNET INC
RE	EVEREST RE GROUP LTD
RECN	RESOURCES CONNECTION
REG	REGENCY CENTERS CORP
REGN	REGENERON PHARMACEUTICA
RELL	RICHARDSON ELECTRONICS
REN	RESOLUTE ENERGY CORP
RENT	RENTRAK CORP
RES	RPC INC
REV	REVLON INC
REX	REX AMERICAN RESOURCES
REXX	REX ENERGY CORP
RF	REGIONS FINANCIAL CORP
RFMD	RF MICRODEVICES INC
RGA	REINSURANCE GRP OF AMER
RGC	REGAL ENTMT GROUP
RGLD	ROYAL GOLD INC
RGR	STURM RUGER & CO INC
RGS	REGIS CORP
RHI	ROBERT HALF INTL INC
RHT	RED HAT INC
RIGL	RIGEL PHARMACEUTICALS
RIMG	RIMAGE CORP
RJET	REPUBLIC AIRWAYS HLD
RJF	RAYMOND JAMES FINANCIAL
RKT	ROCK-TENN CO
RL	POLO RALPH LAUREN CO
RLD	REALD INC
RLH	RED LION HOTELS CORP
RLI	RLI CORP
RLJ	RLJ LODGING TR
RLOC	REACHLOCAL INC
RLRN	RENAISSANCE LEARNING IN
RMBS	RAMBUS INC
RMD	RESMED INC
RMTI	ROCKWELL MEDICAL TECH
RNET	RIGNET INC
RNOW	RIGHTNOW TECHNOLOGIES
RNR	RENAISSANCERE HOLDINGS
RNST	RENASANT CORP
RNWK	REALNETWORKS INC
ROC	ROCKWOOD HOLDINGS INC
ROCK	GIBRALTAR INDUSTRIES IN
ROG	ROGERS CORP
ROIC	RETAIL OPPORTUNITY INVT
ROK	ROCKWELL AUTOMATION INC
ROL	ROLLINS INC
ROLL	RBC BEARINGS INC
ROMA	ROMA FINANCIAL CORP
ROP	ROPER INDUSTRIES INC
ROSE	ROSETTA RESOURCES INC
ROST	ROSS STORES INC
ROVI	ROVI CORPORATION
RP	REALPAGE INC
RPM	RPM INTERNATIONAL INC
RPT	RAMCO-GERSHENSON PPTYS
RPTP	RAPTOR PHARMACEUTICAL
RPXC	RPX CORP
RRC	RANGE RESOURCES CORP
RRD	DONNELLEY R R & SONS CO
RRGB	RED ROBIN GOURMET BURGE
RRR	RSC HOLDINGS INC
RRTS	ROADRUNNER TRNSN SVCS
RS	RELIANCE STEEL & ALUM
RSG	REPUBLIC SERVICES INC
RSH	RADIOSHACK CORP
RSO	RESOURCE CAPITAL CORP
RST	ROSETTA STONE INC
RSTI	ROFIN SINAR TECHNOLOGIE
RSYS	RADISYS CORP
RT	RUBY TUESDAY INC
RTEC	RUDOLPH TECHNOLOGIES IN
RTI	RTI INTERNATIONAL METAL
RTIX	RTI BIOLOGICS INC
RTK	RENTECH INC
RTN	RAYTHEON CO
RUE	RUE21 INC
RURL	RURAL/METRO CORP
RUSHA	RUSH ENTERPRISES INC
RUTH	RUTH'S HOSPITALITY GROU
RVBD	RIVERBED TECHNOLOGY INC
RVM	REVETT MINERALS INC
RWT	REDWOOD TRUST INC
RYL	RYLAND GROUP INC
RYN	RAYONIER INC
S	SPRINT NEXTEL CORP
SAAS	INCONTACT INC
SABA	SABA SOFTWARE INC
SAFM	SANDERSON FARMS INC
SAFT	SAFETY INSURANCE GRP IN
SAH	SONIC AUTOMOTIVE INC
SAI	SAIC INC
SAIA	SAIA INC
SAM	BOSTON BEER INC
SANM	SANMINA SCI CORP
SAPE	SAPIENT CORP
SASR	SANDY SPRING BANCORP
SATC	SATCON TECHNOLOGY CORP
SATS	ECHOSTAR CORP
SAVE	SPIRIT AIRLS INC
SBAC	SBA COMMUNICATIONS CORP
SBCF	SEACOAST BANKING CORP F
SBGI	SINCLAIR BROADCAST GROU
SBH	SALLY BEAUTY HOLDINGS
SBIB	STERLING BANCSHARES
SBNY	SIGNATURE BANK
SBRA	SABRA HEALTH CARE REIT
SBSI	SOUTHSIDE BANCSHARES IN
SBUX	STARBUCKS CORP
SBX	SEABRIGHT HOLDINGS INC
SCBT	SCBT FINANCIAL CORP
SCCO	SOUTHERN COPPER CORP
SCG	SCANA CORP
SCHL	SCHOLASTIC CORP
SCHN	SCHNITZER STEEL INDS
SCHS	SCHOOL SPECIALTY INC
SCHW	SCHWAB CHARLES CORP
SCI	SERVICE CORP INTL
SCL	STEPAN CO
SCLN	SCICLONE PHARMACEUTICAL
SCMP	SUCAMPO PHARMA
SCMR	SYCAMORE NETWORKS INC
SCOR	COMSCORE INC
SCS	STEELCASE INC
SCSC	SCANSOURCE INC
SCSS	SELECT COMFORT CORP
SCVL	SHOE CARNIVAL INC
SD	SANDRIDGE ENERGY INC
SE	SPECTRA ENERGY CORP
SEAC	SEACHANGE INTERNATIONAL
SEB	SEABOARD CORP
SEE	SEALED AIR CORP
SEH	SPARTECH CORP
SEIC	SEI INVESTMENTS CO
SEM	SELECT MEDICAL HOLDINGS
SEMG	SEMGROUP CORP
SENEA	SENECA FOODS CORP
SF	STIFEL FINANCIAL CORP
SFD	SMITHFIELD FOODS INC
SFE	SAFEGUARD SCIENTIFICS
SFG	STANCORP FINANCIAL GROU
SFI	ISTAR FINANCIAL INC
SFL	SHIP FINANCE INTL
SFLY	SHUTTERFLY INC
SFN	SFN GROUP INC
SFNC	SIMMONS FIRST NATIONAL
SFSF	SUCCESSFACTORS INC
SFY	SWIFT ENERGY CO
SGA	SAGA COMMUNICATIONS INC
SGEN	SEATTLE GENETICS INC
SGI	SILICON GRAPHICS INTL
SGK	SCHAWK INC
SGMO	SANGAMO BIOSCIENCES INC
SGMS	SCIENTIFIC GAMES CORP
SGNT	SAGENT PHARMACEUTICALS
SGS	STREAM GLOBAL SVCS INC
SGY	STONE ENERGY CORP
SHAW	SHAW GROUP INC
SHEN	SHENANDOAH TELECOMM CO
SHFL	SHUFFLE MASTER INC
SHLD	SEARS HOLDINGS CORP
SHLM	SCHULMAN A INC
SHLO	SHILOH INDUSTRIES INC
SHO	SUNSTONE HOTEL INVS INC
SHOO	MADDEN STEVEN LTD
SHOR	SHORETEL INC
SHS	SAUER-DANFOSS INC
SHW	SHERWIN WILLIAMS CO
SIAL	SIGMA ALDRICH CORP
SIG	SIGNET JEWELERS LTD
SIGA	SIGA TECHNOLOGIES INC
SIGI	SELECTIVE INSURANCE GRP
SIGM	SIGMA DESIGNS INC
SIMG	SILICON IMAGE INC
SIRI	SIRIUS XM RADIO INC
SIRO	SIRONA DENTAL SYS INC
SIVB	SVB FINANCIAL GROUP
SIX	SIX FLAGS ENTMT CORP NE
SJI	SOUTH JERSEY INDUSTRIES
SJM	SMUCKER J M CO
SJW	SJW CORP
SKH	SKILLED HEALTHCARE GROU
SKS	SAKS INC
SKT	TANGER FACTORY OUTLET
SKX	SKECHERS U S A INC
SKY	SKYLINE CORP
SKYW	SKYWEST INC
SLAB	SILICON LABORATORIES IN
SLB	SCHLUMBERGER LTD
SLE	SARA LEE CORP
SLG	SL GREEN REALTY CORP
SLGN	SILGAN HOLDINGS INC
SLH	SOLERA HOLDINGS INC
SLM	SLM CORP
SLRC	SOLAR CAPITAL LTD
SLTM	SOLTA MEDICAL INC
SLXP	SALIX PHARMACEUTICALS
SM	SM ENERGY CO
SMA	SYMMETRY MEDICAL INC
SMBL	SMART BALANCE INC
SMCI	SUPER MICRO COMPUTER IN
SMG	SCOTTS MIRACLE-GRO CO
SMOD	SMART MODULAR TECH
SMP	STANDARD MOTOR PRODUCTS
SMRT	STEIN MART INC
SMSC	STANDARD MICROSYSTEM
SMSI	SMITH MICRO SOFTWARE IN
SMTC	SEMTECH CORP
SNA	SNAP ON INC
SNBC	SUN BANCORP INC NJ
SNCR	SYNCHRONOSS TECHNOLOGY
SNDK	SANDISK CORP
SNH	SENIOR HOUSING PPTYS TR
SNHY	SUN HYDRAULICS CORP
SNI	SCRIPPS NTWK INTERACTIV
SNMX	SENOMYX INC
SNPS	SYNOPSYS INC
SNSS	SUNESIS PHARMACEUTICALS
SNTA	SYNTA PHARMA CORP
SNTS	SANTARUS INC
SNV	SYNOVUS FINANCIAL CORP
SNX	SYNNEX CORP
SO	SOUTHERN CO
SOA	SOLUTIA INC
SOLR	GT SOLAR INTERNATIONAL
SON	SONOCO PRODUCTS CO
SONC	SONIC CORP
SONE	S1 CORPORATION
SONO	SONOSITE INC
SONS	SONUS NETWORKS INC
SPAR	SPARTAN MOTORS INC
SPB	SPECTRUM BRANDS HOLDING
SPF	STANDARD PACIFIC CORP
SPG	SIMON PROPERTY GROUP IN
SPLS	STAPLES INC
SPN	SUPERIOR ENERGY SERVICE
SPNC	SPECTRANETICS CORP
SPPI	SPECTRUM PHARMACEUTICAL
SPR	SPIRIT AEROSYSTEMS
SPRT	SUPPORT.COM INC
SPSC	SPS COMM INC
SPTN	SPARTAN STORES INC
SPW	SPX CORP
SPWRA	SUNPOWER CORP
SQI	SCIQUEST INC NEW
SQNM	SEQUENOM INC
SRCE	1ST SOURCE CORP
SRCL	STERICYCLE INC
SRDX	SURMODICS INC
SRE	SEMPRA ENERGY
SREV	SERVICESOURCE INTL LLC
SRI	STONERIDGE INC
SRSL	SRS LABS INC
SRX	SRA INTERNATIONAL INC
SRZ	SUNRISE SENIOR LIVING
SSD	SIMPSON MANUFACTURING
SSI	STAGE STORES INC
SSNC	SS&C TECHNOLOGIES HLDGS
SSP	SCRIPPS E W CO
SSS	SOVRAN SELF STORAGE
SSYS	STRATASYS INC
STAA	STAAR SURGICAL CO
STAG	STAG INDL INC
STAN	STANDARD PARKING CORP
STBA	S & T BANCORP INC
STBC	STATE BANCORP INC
STBZ	STATE BK FINL CORP
STC	STEWART INFORMATION
STE	STERIS CORP
STEC	STEC INC
STEI	STEWART ENTERPRISES
STEL	STELLARONE CORP
STFC	STATE AUTO FINANCIAL
STI	SUNTRUST BANKS INC
STJ	ST JUDE MEDICAL INC
STL	STERLING BANCORP
STLD	STEEL DYNAMICS INC
STMP	STAMPS COM INC
STNG	SCORPIO TANKERS INC
STNR	STEINER LEISURE LTD
STR	QUESTAR CORP
STRA	STRAYER EDUCATION INC
STRI	STR HOLDINGS INC
STRL	STERLING CONSTRUCTION C
STSA	STERLING FINL CORP WASH
STT	STATE STREET CORP
STWD	STARWOOD PPTY TRUST INC
STXS	STEREOTAXIS INC
STZ	CONSTELLATION BRANDS
SUBK	SUFFOLK BANCORP
SUG	SOUTHERN UNION CO
SUI	SUN COMMUNITIES INC
SUMR	SUMMER INFANT INC
SUN	SUNOCO INC
SUNH	SUN HEALTHCARE GROUP IN
SUNS	SOLAR SENIOR CAP LTD
SUP	SUPERIOR INDUSTRIES INT
SUPG	SUPERGEN INC
SUPX	SUPERTEX INC
SURG	SYNERGETICS USA INC
SURW	SUREWEST COMMUNICATIONS
SUSQ	SUSQUEHANNA BANCSHARES
SUSS	SUSSER HOLDINGS CORP
SVNT	SAVIENT PHARMACEUTICALS
SVU	SUPERVALU INC
SVVS	SAVVIS INC
SWC	STILLWATER MINING CO
SWFT	SWIFT TRANSN CO
SWHC	SMITH & WESSON HOLDING
SWI	SOLARWINDS INC
SWK	STANLEY BLACK & DECKER
SWKS	SKYWORKS SOLUTIONS INC
SWM	SCHWEITZER-MAUDUIT INTL
SWN	SOUTHWESTERN ENERGY CO
SWS	SWS GROUP INC
SWSH	SWISHER HYGIENE INC
SWX	SOUTHWEST GAS CORP
SWY	SAFEWAY INC
SXCI	SXC HEALTH SOLUTIONS
SXI	STANDEX INTERNATIONAL
SXT	SENSIENT TECHNOLOGIES
SYA	SYMETRA FINANCIAL CORP
SYBT	S Y BANCORP INC
SYK	STRYKER CORP
SYKE	SYKES ENTERPRISES INC
SYMC	SYMANTEC CORP
SYMM	SYMMETRICOM INC
SYMS	SYMS CORP
SYNA	SYNAPTICS INC
SYNM	SYNTROLEUM CORP
SYNO	SYNOVIS LIFE TECH INC
SYNT	SYNTEL INC
SYUT	SYNUTRA INTL INC
SYX	SYSTEMAX INC
SYY	SYSCO CORP
SZYM	SOLAZYME INC
T	AT&T INC
TAL	TAL INTERNATIONAL GROUP
TAP	MOLSON COORS BREWING CO
TASR	TASER INTL INC
TAST	CARROLS RESTAURANT GRP
TAXI	MEDALLION FINANCIAL COR
TAYC	TAYLOR CAPITAL GROUP IN
TBBK	BANCORP INC
TBI	TRUEBLUE INC
TBL	TIMBERLAND CO
TBNK	TERRITORIAL BANCORP INC
TC	THOMPSON CREEK METALS
TCAP	TRIANGLE CAPITAL CORP
TCB	TCF FINANCIAL CORP
TCBI	TEXAS CAPITAL BANCSHARE
TCBK	TRICO BANCSHARES
TCO	TAUBMAN CENTERS INC
TCRD	THL CR INC
TDC	TERADATA CORP
TDG	TRANSDIGM GROUP INC
TDS	TELEPHONE & DATA SYSTEM
TDW	TIDEWATER INC
TDY	TELEDYNE TECHNOLOGIES
TE	TECO ENERGY INC
TECD	TECH DATA CORP
TECH	TECHNE CORP
TECUA	TECUMSEH PRODS CO
TEG	INTEGRYS ENERGY GROUP
TEN	TENNECO INC
TER	TERADYNE INC
TESO	TESCO CORP
TEX	TEREX CORP
TFM	FRESH MARKET INC
TFSL	TFS FINL CORP
TFX	TELEFLEX INC
TG	TREDEGAR CORP
TGH	TEXTAINER GROUP HLDGS
TGI	TRIUMPH GROUP INC
TGT	TARGET CORP
THC	TENET HEALTHCARE CORP
THFF	FIRST FINANCIAL CORP
THG	HANOVER INSURANCE GROUP
THO	THOR INDUSTRIES INC
THOR	THORATEC CORP
THQI	THQ INC
THR	THERMON GROUP HLDGS INC
THRX	THERAVANCE INC
THS	TREEHOUSE FOODS INC
TIBX	TIBCO SOFTWARE INC
TICC	TICC CAPITAL CORP
TIE	TITANIUM METALS CORP
TIF	TIFFANY & CO
TIN	TEMPLE INLAND INC
TINY	HARRIS & HARRIS GROUP
TISI	TEAM INC
TITN	TITAN MACHINERY INC
TIVO	TIVO INC
TJX	TJX COMPANIES INC
TK	TEEKAY CORP
TKLC	TEKELEC
TKR	TIMKEN CO
TLAB	TELLABS INC
TLB	TALBOTS INC
TLEO	TALEO CORP
TMH	TEAM HEALTH HOLDINGS IN
TMK	TORCHMARK CORP
TMO	THERMO FISHER SCIENTIFI
TMP	TOMPKINS FINANCIAL CORP
TMS	TMS INTL CORP
TNAV	TELENAV INC
TNB	THOMAS & BETTS CORP
TNC	TENNANT CO
TNDM	NEUTRAL TANDEM INC
TNK	TEEKAY TANKERS LTD
TNS	TNS INC
TOBC	TOWER BANCORP INC
TOL	TOLL BROTHERS INC
TOWN	TOWNEBANK PORTSMOUTH VA
TOWR	TOWER INTERNATIONAL INC
TPC	TUTOR PERINI CORP
TPCG	TPC GROUP INC
TPLM	TRIANGLE PETE CORP
TPX	TEMPUR PEDIC INTL INC
TQNT	TRIQUINT SEMICONDUCTOR
TR	TOOTSIE ROLL INDUSTRIES
TRAK	DEALERTRACK HOLDINGS IN
TRC	TEJON RANCH CO
TRCR	TRANSCEND SERVICES INC
TREX	TREX INC
TRGP	TARGA RESOURCES INC
TRGT	TARGACEPT INC
TRH	TRANSATLANTIC HLDGS INC
TRI	THOMSON REUTERS CORP
TRK	SPEEDWAY MOTORSPORTS IN
TRLG	TRUE RELIGION APPAREL
TRMB	TRIMBLE NAVIGATION LTD
TRMK	TRUSTMARK CORP
TRN	TRINITY INDUSTRIES INC
TRNO	TERRENO REALTY CORP
TRNX	TORNIER N V
TROW	PRICE T ROWE GROUP INC
TRR	TRC COS INC
TRS	TRIMAS CORP
TRST	TRUSTCO BANK CORP NY
TRV	TRAVELERS COS INC
TRW	TRW AUTOMOTIVE HLDGS
TSCO	TRACTOR SUPPLY CO
TSLA	TESLA MTRS INC
TSN	TYSON FOODS INC
TSO	TESORO CORP
TSPT	TRANSCEPT PHARM INC
TSRA	TESSERA TECHNOLOGIES IN
TSRX	TRIUS THERAPEUTICS INC
TSS	TOTAL SYSTEM SERVICES
TSYS	TELECOMMUNICATION SYSTE
TTC	TORO CO
TTEC	TELETECH HOLDINGS INC
TTEK	TETRA TECH INC
TTGT	TECHTARGET INC
TTI	TETRA TECHNOLOGIES INC
TTMI	TTM TECHNOLOGIES INC
TTWO	TAKE-TWO INTERACTIVE
TUC	MAC-GRAY CORP
TUES	TUESDAY MORNING CORP
TUP	TUPPERWARE BRANDS CORP
TVL	LIN TV CORP
TW	TOWERS WATSON & COMPANY
TWC	TIME WARNER CABLE INC
TWER	TOWERSTREAM CORP
TWGP	TOWER GROUP INC
TWI	TITAN INTERNATIONAL INC
TWIN	TWIN DISC INC
TWO	TWO HBRS INVT CORP
TWTC	TW TELECOM INC
TWX	TIME WARNER INC
TXI	TEXAS INDUSTRIES INC
TXN	TEXAS INSTRUMENTS INC
TXRH	TEXAS ROADHOUSE INC
TXT	TEXTRON INC
TYC	TYCO INTERNATIONAL LTD
TYL	TYLER TECHNOLOGIES INC
TYPE	MONOTYPE IMAGING HLDG
TZOO	TRAVELZOO INC
UA	UNDER ARMOUR INC
UACL	UNIVERSAL TRUCKLOAD SVC
UAL	UNITED CONTINENTAL HLDG
UAM	UNIVERSAL AMERICAN CORP
UBA	URSTADT BIDDLE PPTYS IN
UBNK	UNITED FINANCIAL BANCOR
UBSH	UNION FIRST MARKET BKSH
UBSI	UNITED BANKSHARES INC
UCBID	UNITED COMMUNITY BANKS
UCTT	ULTRA CLEAN HOLDINGS IN
UDR	UDR INC
UDRL	UNION DRILLING INC
UEC	URANIUM ENERGY CORP
UEIC	UNIVERSAL ELECTRONICS
UFCS	UNITED FIRE & CAS CO
UFI	UNIFI INC
UFPI	UNIVERSAL FOREST PRODS
UFS	DOMTAR CORPORATION
UGI	UGI CORP
UHAL	AMERCO
UHS	UNIVERSAL HEALTH SVCS
UHT	UNIVERSAL HEALTH REALTY
UIL	UIL HOLDINGS CORP
UIS	UNISYS CORP
ULTA	ULTA SALON COSMETICS
ULTI	ULTIMATE SOFTWARE GROUP
ULTR	ULTRAPETROL BAHAMAS LTD
UMBF	UMB FINANCIAL CORP
UMH	UMH PROPERTIES INC
UMPQ	UMPQUA HOLDINGS CORP
UNF	UNIFIRST CORP MASS
UNFI	UNITED NATURAL FOODS IN
UNH	UNITEDHEALTH GROUP INC
UNIS	UNILIFE CORP NEW
UNM	UNUM GROUP
UNP	UNION PACIFIC CORP
UNS	UNISOURCE ENERGY CORP
UNT	UNIT CORP
UNTD	UNITED ONLINE INC
UNTK	UNITEK GLOBAL SVCS INC
UPI	UROPLASTY INC
UPL	ULTRA PETROLEUM CORP
UPS	UNITED PARCEL SERVICE
URBN	URBAN OUTFITTERS INC
URG	UR ENERGY INC
URI	UNITED RENTALS INC
URRE	URANIUM RES INC
URS	URS CORP
URZ	URANERZ ENERGY CORP
USAP	UNIVERSAL STAINLESS & A
USB	US BANCORP
USEG	U S ENERGY CORP
USG	U S G CORP
USLM	UNITED STATES LIME & MI
USM	UNITED STATES CELLULAR
USMO	USA MOBILITY INC
USNA	USANA HEALTH SCIENCES
USPH	U S PHYSICAL THERAPY IN
USTR	UNITED STATIONERS INC
USU	USEC INC
UTEK	ULTRATECH INC
UTHR	UNITED THERAPEUTICS
UTI	UNIVERSAL TECHNICAL INS
UTIW	UTI WORLDWIDE INC
UTL	UNITIL CORP
UTR	UNITRIN INC
UTX	UNITED TECHNOLOGIES
UVE	UNIVERSAL INSURANCE
UVSP	UNIVEST CORP OF PENN
UVV	UNIVERSAL CORP
UXG	US GOLD CORP
V	VISA INC
VAL	VALSPAR CORP
VALU	VALUE LINE INC
VAR	VARIAN MEDICAL SYSTEMS
VASC	VASCULAR SOLUTIONS INC
VC	VISTEON CORP
VCBI	VIRGINIA COMM BANCORP
VCI	VALASSIS COMMUNICATIONS
VCLK	VALUECLICK INC
VDSI	VASCO DATA SECURITY INT
VECO	VEECO INSTRUMENTS INC
VFC	V F CORP
VG	VONAGE HLDGS CORP
VGR	VECTOR GROUP LTD
VGZ	VISTA GOLD CORP
VHC	VIRNETX HOLDING CORP
VIA.B	VIACOM INC
VIAS	VIASYSTEMS GROUP INC
VICL	VICAL INC
VICR	VICOR CORP
VITA	ORTHOVITA INC
VIVO	MERIDIAN BIOSCIENCE INC
VLCCF	KNIGHTSBRIDGE TANKERS
VLGEA	VILLAGE SUPER MARKET IN
VLNC	VALENCE TECHNOLOGY INC
VLO	VALERO ENERGY CORP
VLTR	VOLTERRA SEMICONDUCTOR
VLY	VALLEY NATIONAL BANCORP
VMC	VULCAN MATERIALS CO
VMED	VIRGIN MEDIA INC
VMI	VALMONT INDUSTRIES INC
VMW	VMWARE INC
VNDA	VANDA PHARMACEUTICALS
VNO	VORNADO REALTY TRUST
VOCS	VOCUS INC
VOG	VOYAGER OIL & GAS INC
VOLC	VOLCANO CORP
VOXX	AUDIOVOX CORP
VPFG	VIEWPOINT FINL GROUP
VPG	VISHAY PRECISION GROUP
VPHM	VIROPHARMA INC
VPRT	VISTAPRINT N V
VQ	VENOCO INC
VR	VALIDUS HOLDINGS LTD
VRA	VERA BRADLEY INC
VRNT	VERINT SYS INC
VRS	VERSO PAPER CORP
VRSK	VERISK ANALYTICS INC
VRSN	VERISIGN INC
VRTS	VIRTUS INVESTMENT PTNRS
VRTU	VIRTUSA CORP
VRTX	VERTEX PHARMACEUTICALS
VRUS	PHARMASSET INC
VSAT	VIASAT INC
VSEA	VARIAN SEMICONDUCTOR
VSEC	VSE CORP
VSH	VISHAY INTERTECHNOLOGY
VSI	VITAMIN SHOPPE INC
VTG	VANTAGE DRILLING COMPAN
VTR	VENTAS INC
VVC	VECTREN CORP
VVI	VIAD CORP
VVTV	VALUEVISION MEDIA INC
VVUS	VIVUS INC
VZ	VERIZON COMMUNICATIONS
WAB	WABTEC CORP
WABC	WESTAMERICA BANCORP
WAC	WALTER INV MGMT CORP
WAG	WALGREEN CO
WAL	WESTERN ALLIANCE BANCOR
WASH	WASHINGTON TRUST BANCOR
WAT	WATERS CORP
WAVX	WAVE SYSTEMS CORP
WBC	WABCO HOLDINGS INC
WBCO	WASHINGTON BANKING CO
WBMD	WEBMD HEALTH CORP
WBS	WEBSTER FINANCIAL CORP
WBSN	WEBSENSE INC
WCAA	WCA WASTE CORP
WCBO	WEST COAST BANCORP
WCC	WESCO INTERNATIONAL INC
WCG	WELLCARE GROUP INC
WCN	WASTE CONNECTIONS INC
WCRX	WARNER CHILCOTT PLC
WD	WALKER & DUNLOP INC
WDC	WESTERN DIGITAL CORP
WDFC	WD-40 CO
WDR	WADDELL & REED FINANCIA
WEC	WISCONSIN ENERGY CORP
WEN	WENDY'S/ARBY'S GROUP IN
WERN	WERNER ENTERPRISES INC
WEYS	WEYCO GROUP INC
WFC	WELLS FARGO & CO
WFD	WESTFIELD FINANCIAL INC
WFM	WHOLE FOODS MARKET INC
WFR	MEMC ELECTRIC MATERIALS
WFSL	WASHINGTON FED INC
WG	WILLBROS GROUP INC
WGL	WGL HOLDINGS INC
WGO	WINNEBAGO INDUSTRIES IN
WHG	WESTWOOD HOLDINGS GROUP
WHR	WHIRLPOOL CORP
WIBC	WILSHIRE BANCORP INC
WIFI	BOINGO WIRELESS INC
WIN	WINDSTREAM CORP
WINA	WINMARK CORP
WINN	WINN DIXIE STORES INC
WIRE	ENCORE WIRE CORP
WLB	WESTMORELAND COAL CO
WLK	WESTLAKE CHEMICAL CORP
WLL	WHITING PETROLEUM CORP
WLP	WELLPOINT INC
WLT	WALTER ENERGY INC
WM	WASTE MGMT INC
WMAR	WEST MARINE INC
WMB	WILLIAMS COMPANIES INC
WMG	WARNER MUSIC GROUP CORP
WMGI	WRIGHT MEDICAL GROUP IN
WMK	WEIS MARKETS INC
WMS	WMS INDUSTRIES INC
WMT	WAL MART STORES INC
WNC	WABASH NATIONAL CORP
WNI	SCHIFF NUTRITION INTL
WNR	WESTERN REFINING INC
WOOF	VCA ANTECH INC
WOR	WORTHINGTON INDUSTRIES
WPI	WATSON PHARMACEUTICALS
WPO	WASHINGTON POST CO
WPP	WAUSAU PAPER CORP
WR	WESTAR ENERGY INC
WRB	BERKLEY W R CORP
WRC	WARNACO GROUP INC
WRE	WASHINGTON REAL ESTATE
WRES	WARREN RESOURCES INC
WRI	WEINGARTEN RLTY INVS
WRLD	WORLD ACCEPTANCE CORP
WSBC	WESBANCO INC
WSC	WESCO FINANCIAL CORP
WSFS	WSFS FINANCIAL CORP
WSM	WILLIAMS SONOMA INC
WSO	WATSCO INC
WSR	WHITESTONE REIT
WST	WEST PHARMACEUTICAL SVC
WSTL	WESTELL TECHNOLOGIES IN
WTBA	WEST BANCORPORATION INC
WTFC	WINTRUST FINANCIAL CORP
WTI	W&T OFFSHORE INC
WTM	WHITE MTNS INS GROUP LT
WTR	AQUA AMERICA INC
WTS	WATTS WATER TECH INC
WTSLA	WET SEAL INC
WTW	WEIGHT WATCHERS INTL IN
WU	WESTERN UNION CO
WWD	WOODWARD INC
WWE	WORLD WRESTLING ENTMNT
WWON	WESTWOOD ONE INC
WWW	WOLVERINE WORLD WIDE
WWWW	WEB.COM GROUP INC
WXS	WRIGHT EXPRESS CORP
WY	WEYERHAEUSER CO
WYN	WYNDHAM WORLDWIDE CORP
WYNN	WYNN RESORTS LTD
X	UNITED STATES STEEL COR
XCO	EXCO RESOURCES INC
XEC	CIMAREX ENERGY CO
XEL	XCEL ENERGY INC
XIDE	EXIDE TECHNOLOGIES
XL	XL GROUP PLC
XLNX	XILINX INC
XNPT	XENOPORT INC
XOM	EXXON MOBIL CORP
XRAY	DENTSPLY INTERNATIONAL
XRIT	X-RITE INC
XRM	XERIUM TECHNOLOGIES INC
XRTX	XYRATEX LTD
XRX	XEROX CORP
XTXI	CROSSTEX ENERGY INC
XXIA	IXIA
Y	ALLEGHANY CORP
YDNT	YOUNG INNOVATIONS INC
YHOO	YAHOO INC
YORW	YORK WATER COMPANY
YSI	U STORE IT TRUST
YUM	YUM! BRANDS INC
ZAGG	ZAGG INCORPORATED
ZBRA	ZEBRA TECHNOLOGIES CORP
ZEP	ZEP INC
ZEUS	OLYMPIC STEEL INC
ZGNX	ZOGENIX INC
ZIGO	ZYGO CORP
ZINC	HORSEHEAD HOLDING CORP
ZION	ZIONS BANCORPORATION
ZIOP	ZIOPHARM ONCOLOGY INC
ZIP	ZIPCAR INC
ZIXI	ZIX CORP
ZLC	ZALE CORP
ZLCS	ZALICUS INC
ZMH	ZIMMER HOLDINGS INC
ZN	ZION OIL & GAS INC
ZOLL	ZOLL MEDICAL CORP
ZOLT	ZOLTEK COMPANIES INC
ZQK	QUIKSILVER INC
ZRAN	ZORAN CORP
ZUMZ	ZUMIEZ INC
ZZ	SEALY CORP
